nhs_england_region,date,new_deaths_with_positive_test,cumulative_deaths_with_positive_test,new_deaths_without_positive_test,cumulative_deaths_without_positive_test,new_deaths_total,cumulative_deaths_total,data_subject_to_change
North East And Yorkshire,29/02/2020,0,0,0,0,0,0,FALSE
North East And Yorkshire,01/03/2020,0,0,0,0,0,0,FALSE
North East And Yorkshire,02/03/2020,0,0,0,0,0,0,FALSE
North East And Yorkshire,03/03/2020,0,0,0,0,0,0,FALSE
North East And Yorkshire,04/03/2020,0,0,0,0,0,0,FALSE
North East And Yorkshire,05/03/2020,0,0,0,0,0,0,FALSE
North East And Yorkshire,06/03/2020,0,0,0,0,0,0,FALSE
North East And Yorkshire,07/03/2020,0,0,0,0,0,0,FALSE
North East And Yorkshire,08/03/2020,0,0,0,0,0,0,FALSE
North East And Yorkshire,09/03/2020,0,0,0,0,0,0,FALSE
North East And Yorkshire,10/03/2020,0,0,0,0,0,0,FALSE
North East And Yorkshire,11/03/2020,0,0,0,0,0,0,FALSE
North East And Yorkshire,12/03/2020,0,0,0,0,0,0,FALSE
North East And Yorkshire,13/03/2020,0,0,0,0,0,0,FALSE
North East And Yorkshire,14/03/2020,0,0,0,0,0,0,FALSE
North East And Yorkshire,15/03/2020,2,2,0,0,2,2,FALSE
North East And Yorkshire,16/03/2020,3,5,0,0,3,5,FALSE
North East And Yorkshire,17/03/2020,1,6,0,0,1,6,FALSE
North East And Yorkshire,18/03/2020,2,8,0,0,2,8,FALSE
North East And Yorkshire,19/03/2020,6,14,0,0,6,14,FALSE
North East And Yorkshire,20/03/2020,5,19,0,0,5,19,FALSE
North East And Yorkshire,21/03/2020,6,25,0,0,6,25,FALSE
North East And Yorkshire,22/03/2020,7,32,0,0,7,32,FALSE
North East And Yorkshire,23/03/2020,9,41,0,0,9,41,FALSE
North East And Yorkshire,24/03/2020,8,49,0,0,8,49,FALSE
North East And Yorkshire,25/03/2020,18,67,0,0,18,67,FALSE
North East And Yorkshire,26/03/2020,21,88,0,0,21,88,FALSE
North East And Yorkshire,27/03/2020,28,116,0,0,28,116,FALSE
North East And Yorkshire,28/03/2020,35,151,0,0,35,151,FALSE
North East And Yorkshire,29/03/2020,38,189,0,0,38,189,FALSE
North East And Yorkshire,30/03/2020,64,253,0,0,64,253,FALSE
North East And Yorkshire,31/03/2020,60,313,0,0,60,313,FALSE
North East And Yorkshire,01/04/2020,67,380,0,0,67,380,FALSE
North East And Yorkshire,02/04/2020,75,455,0,0,75,455,FALSE
North East And Yorkshire,03/04/2020,100,555,0,0,100,555,FALSE
North East And Yorkshire,04/04/2020,105,660,0,0,105,660,FALSE
North East And Yorkshire,05/04/2020,92,752,0,0,92,752,FALSE
North East And Yorkshire,06/04/2020,96,848,0,0,96,848,FALSE
North East And Yorkshire,07/04/2020,102,950,0,0,102,950,FALSE
North East And Yorkshire,08/04/2020,108,1058,0,0,108,1058,FALSE
North East And Yorkshire,09/04/2020,111,1169,0,0,111,1169,FALSE
North East And Yorkshire,10/04/2020,117,1286,0,0,117,1286,FALSE
North East And Yorkshire,11/04/2020,98,1384,0,0,98,1384,FALSE
North East And Yorkshire,12/04/2020,84,1468,0,0,84,1468,FALSE
North East And Yorkshire,13/04/2020,94,1562,0,0,94,1562,FALSE
North East And Yorkshire,14/04/2020,107,1669,0,0,107,1669,FALSE
North East And Yorkshire,15/04/2020,96,1765,0,0,96,1765,FALSE
North East And Yorkshire,16/04/2020,103,1868,0,0,103,1868,FALSE
North East And Yorkshire,17/04/2020,88,1956,0,0,88,1956,FALSE
North East And Yorkshire,18/04/2020,95,2051,0,0,95,2051,FALSE
North East And Yorkshire,19/04/2020,88,2139,0,0,88,2139,FALSE
North East And Yorkshire,20/04/2020,100,2239,0,0,100,2239,FALSE
North East And Yorkshire,21/04/2020,76,2315,0,0,76,2315,FALSE
North East And Yorkshire,22/04/2020,84,2399,0,0,84,2399,FALSE
North East And Yorkshire,23/04/2020,63,2462,0,0,63,2462,FALSE
North East And Yorkshire,24/04/2020,72,2534,1,1,73,2535,FALSE
North East And Yorkshire,25/04/2020,69,2603,0,1,69,2604,FALSE
North East And Yorkshire,26/04/2020,65,2668,0,1,65,2669,FALSE
North East And Yorkshire,27/04/2020,65,2733,2,3,67,2736,FALSE
North East And Yorkshire,28/04/2020,57,2790,4,7,61,2797,FALSE
North East And Yorkshire,29/04/2020,69,2859,4,11,73,2870,FALSE
North East And Yorkshire,30/04/2020,57,2916,4,15,61,2931,FALSE
North East And Yorkshire,01/05/2020,64,2980,5,20,69,3000,FALSE
North East And Yorkshire,02/05/2020,48,3028,5,25,53,3053,FALSE
North East And Yorkshire,03/05/2020,40,3068,2,27,42,3095,FALSE
North East And Yorkshire,04/05/2020,49,3117,2,29,51,3146,FALSE
North East And Yorkshire,05/05/2020,40,3157,4,33,44,3190,FALSE
North East And Yorkshire,06/05/2020,52,3209,4,37,56,3246,FALSE
North East And Yorkshire,07/05/2020,45,3254,3,40,48,3294,FALSE
North East And Yorkshire,08/05/2020,42,3296,4,44,46,3340,FALSE
North East And Yorkshire,09/05/2020,44,3340,1,45,45,3385,FALSE
North East And Yorkshire,10/05/2020,40,3380,1,46,41,3426,FALSE
North East And Yorkshire,11/05/2020,29,3409,5,51,34,3460,FALSE
North East And Yorkshire,12/05/2020,27,3436,1,52,28,3488,FALSE
North East And Yorkshire,13/05/2020,28,3464,3,55,31,3519,FALSE
North East And Yorkshire,14/05/2020,31,3495,1,56,32,3551,FALSE
North East And Yorkshire,15/05/2020,32,3527,3,59,35,3586,FALSE
North East And Yorkshire,16/05/2020,35,3562,2,61,37,3623,FALSE
North East And Yorkshire,17/05/2020,26,3588,1,62,27,3650,FALSE
North East And Yorkshire,18/05/2020,30,3618,4,66,34,3684,FALSE
North East And Yorkshire,19/05/2020,27,3645,2,68,29,3713,FALSE
North East And Yorkshire,20/05/2020,22,3667,2,70,24,3737,FALSE
North East And Yorkshire,21/05/2020,33,3700,3,73,36,3773,FALSE
North East And Yorkshire,22/05/2020,22,3722,5,78,27,3800,FALSE
North East And Yorkshire,23/05/2020,18,3740,0,78,18,3818,FALSE
North East And Yorkshire,24/05/2020,26,3766,4,82,30,3848,FALSE
North East And Yorkshire,25/05/2020,21,3787,1,83,22,3870,FALSE
North East And Yorkshire,26/05/2020,21,3808,0,83,21,3891,FALSE
North East And Yorkshire,27/05/2020,23,3831,1,84,24,3915,FALSE
North East And Yorkshire,28/05/2020,21,3852,6,90,27,3942,FALSE
North East And Yorkshire,29/05/2020,25,3877,2,92,27,3969,FALSE
North East And Yorkshire,30/05/2020,20,3897,3,95,23,3992,FALSE
North East And Yorkshire,31/05/2020,20,3917,1,96,21,4013,FALSE
North East And Yorkshire,01/06/2020,17,3934,0,96,17,4030,FALSE
North East And Yorkshire,02/06/2020,23,3957,3,99,26,4056,FALSE
North East And Yorkshire,03/06/2020,24,3981,2,101,26,4082,FALSE
North East And Yorkshire,04/06/2020,17,3998,2,103,19,4101,FALSE
North East And Yorkshire,05/06/2020,18,4016,2,105,20,4121,FALSE
North East And Yorkshire,06/06/2020,21,4037,1,106,22,4143,FALSE
North East And Yorkshire,07/06/2020,14,4051,0,106,14,4157,FALSE
North East And Yorkshire,08/06/2020,11,4062,2,108,13,4170,FALSE
North East And Yorkshire,09/06/2020,12,4074,3,111,15,4185,FALSE
North East And Yorkshire,10/06/2020,19,4093,1,112,20,4205,FALSE
North East And Yorkshire,11/06/2020,7,4100,0,112,7,4212,FALSE
North East And Yorkshire,12/06/2020,9,4109,2,114,11,4223,FALSE
North East And Yorkshire,13/06/2020,10,4119,1,115,11,4234,FALSE
North East And Yorkshire,14/06/2020,11,4130,1,116,12,4246,FALSE
North East And Yorkshire,15/06/2020,9,4139,2,118,11,4257,FALSE
North East And Yorkshire,16/06/2020,10,4149,1,119,11,4268,FALSE
North East And Yorkshire,17/06/2020,9,4158,1,120,10,4278,FALSE
North East And Yorkshire,18/06/2020,11,4169,0,120,11,4289,FALSE
North East And Yorkshire,19/06/2020,6,4175,1,121,7,4296,FALSE
North East And Yorkshire,20/06/2020,5,4180,1,122,6,4302,FALSE
North East And Yorkshire,21/06/2020,4,4184,2,124,6,4308,FALSE
North East And Yorkshire,22/06/2020,7,4191,0,124,7,4315,FALSE
North East And Yorkshire,23/06/2020,8,4199,1,125,9,4324,FALSE
North East And Yorkshire,24/06/2020,10,4209,1,126,11,4335,FALSE
North East And Yorkshire,25/06/2020,4,4213,0,126,4,4339,FALSE
North East And Yorkshire,26/06/2020,8,4221,1,127,9,4348,FALSE
North East And Yorkshire,27/06/2020,4,4225,0,127,4,4352,FALSE
North East And Yorkshire,28/06/2020,5,4230,1,128,6,4358,FALSE
North East And Yorkshire,29/06/2020,2,4232,1,129,3,4361,FALSE
North East And Yorkshire,30/06/2020,7,4239,0,129,7,4368,FALSE
North East And Yorkshire,01/07/2020,1,4240,1,130,2,4370,FALSE
North East And Yorkshire,02/07/2020,5,4245,1,131,6,4376,FALSE
North East And Yorkshire,03/07/2020,4,4249,1,132,5,4381,FALSE
North East And Yorkshire,04/07/2020,4,4253,1,133,5,4386,FALSE
North East And Yorkshire,05/07/2020,3,4256,2,135,5,4391,FALSE
North East And Yorkshire,06/07/2020,2,4258,0,135,2,4393,FALSE
North East And Yorkshire,07/07/2020,3,4261,0,135,3,4396,FALSE
North East And Yorkshire,08/07/2020,3,4264,1,136,4,4400,FALSE
North East And Yorkshire,09/07/2020,0,4264,0,136,0,4400,FALSE
North East And Yorkshire,10/07/2020,3,4267,1,137,4,4404,FALSE
North East And Yorkshire,11/07/2020,1,4268,1,138,2,4406,FALSE
North East And Yorkshire,12/07/2020,4,4272,0,138,4,4410,FALSE
North East And Yorkshire,13/07/2020,1,4273,1,139,2,4412,FALSE
North East And Yorkshire,14/07/2020,1,4274,3,142,4,4416,FALSE
North East And Yorkshire,15/07/2020,2,4276,2,144,4,4420,FALSE
North East And Yorkshire,16/07/2020,3,4279,0,144,3,4423,FALSE
North East And Yorkshire,17/07/2020,1,4280,0,144,1,4424,FALSE
North East And Yorkshire,18/07/2020,2,4282,0,144,2,4426,FALSE
North East And Yorkshire,19/07/2020,2,4284,0,144,2,4428,FALSE
North East And Yorkshire,20/07/2020,1,4285,0,144,1,4429,FALSE
North East And Yorkshire,21/07/2020,1,4286,0,144,1,4430,FALSE
North East And Yorkshire,22/07/2020,6,4292,2,146,8,4438,FALSE
North East And Yorkshire,23/07/2020,0,4292,1,147,1,4439,FALSE
North East And Yorkshire,24/07/2020,1,4293,0,147,1,4440,FALSE
North East And Yorkshire,25/07/2020,5,4298,1,148,6,4446,FALSE
North East And Yorkshire,26/07/2020,1,4299,1,149,2,4448,FALSE
North East And Yorkshire,27/07/2020,0,4299,2,151,2,4450,FALSE
North East And Yorkshire,28/07/2020,2,4301,0,151,2,4452,FALSE
North East And Yorkshire,29/07/2020,1,4302,3,154,4,4456,FALSE
North East And Yorkshire,30/07/2020,0,4302,0,154,0,4456,FALSE
North East And Yorkshire,31/07/2020,1,4303,0,154,1,4457,FALSE
North East And Yorkshire,01/08/2020,3,4306,0,154,3,4460,FALSE
North East And Yorkshire,02/08/2020,2,4308,0,154,2,4462,FALSE
North East And Yorkshire,03/08/2020,1,4309,0,154,1,4463,FALSE
North East And Yorkshire,04/08/2020,3,4312,0,154,3,4466,FALSE
North East And Yorkshire,05/08/2020,1,4313,0,154,1,4467,FALSE
North East And Yorkshire,06/08/2020,4,4317,0,154,4,4471,FALSE
North East And Yorkshire,07/08/2020,0,4317,0,154,0,4471,FALSE
North East And Yorkshire,08/08/2020,2,4319,0,154,2,4473,FALSE
North East And Yorkshire,09/08/2020,3,4322,0,154,3,4476,FALSE
North East And Yorkshire,10/08/2020,3,4325,1,155,4,4480,FALSE
North East And Yorkshire,11/08/2020,2,4327,1,156,3,4483,FALSE
North East And Yorkshire,12/08/2020,2,4329,0,156,2,4485,FALSE
North East And Yorkshire,13/08/2020,0,4329,0,156,0,4485,FALSE
North East And Yorkshire,14/08/2020,1,4330,0,156,1,4486,FALSE
North East And Yorkshire,15/08/2020,1,4331,1,157,2,4488,FALSE
North East And Yorkshire,16/08/2020,0,4331,0,157,0,4488,FALSE
North East And Yorkshire,17/08/2020,6,4337,0,157,6,4494,FALSE
North East And Yorkshire,18/08/2020,1,4338,1,158,2,4496,FALSE
North East And Yorkshire,19/08/2020,0,4338,0,158,0,4496,FALSE
North East And Yorkshire,20/08/2020,0,4338,0,158,0,4496,FALSE
North East And Yorkshire,21/08/2020,1,4339,3,161,4,4500,FALSE
North East And Yorkshire,22/08/2020,1,4340,0,161,1,4501,FALSE
North East And Yorkshire,23/08/2020,3,4343,0,161,3,4504,FALSE
North East And Yorkshire,24/08/2020,0,4343,0,161,0,4504,FALSE
North East And Yorkshire,25/08/2020,2,4345,0,161,2,4506,FALSE
North East And Yorkshire,26/08/2020,2,4347,0,161,2,4508,FALSE
North East And Yorkshire,27/08/2020,1,4348,0,161,1,4509,FALSE
North East And Yorkshire,28/08/2020,0,4348,1,162,1,4510,FALSE
North East And Yorkshire,29/08/2020,1,4349,0,162,1,4511,FALSE
North East And Yorkshire,30/08/2020,0,4349,0,162,0,4511,FALSE
North East And Yorkshire,31/08/2020,0,4349,0,162,0,4511,FALSE
North East And Yorkshire,01/09/2020,2,4351,0,162,2,4513,FALSE
North East And Yorkshire,02/09/2020,3,4354,1,163,4,4517,FALSE
North East And Yorkshire,03/09/2020,1,4355,0,163,1,4518,FALSE
North East And Yorkshire,04/09/2020,1,4356,1,164,2,4520,FALSE
North East And Yorkshire,05/09/2020,2,4358,0,164,2,4522,FALSE
North East And Yorkshire,06/09/2020,1,4359,1,165,2,4524,FALSE
North East And Yorkshire,07/09/2020,0,4359,0,165,0,4524,FALSE
North East And Yorkshire,08/09/2020,1,4360,1,166,2,4526,FALSE
North East And Yorkshire,09/09/2020,2,4362,0,166,2,4528,FALSE
North East And Yorkshire,10/09/2020,0,4362,0,166,0,4528,FALSE
North East And Yorkshire,11/09/2020,3,4365,1,167,4,4532,FALSE
North East And Yorkshire,12/09/2020,1,4366,0,167,1,4533,FALSE
North East And Yorkshire,13/09/2020,3,4369,1,168,4,4537,FALSE
North East And Yorkshire,14/09/2020,4,4373,0,168,4,4541,FALSE
North East And Yorkshire,15/09/2020,3,4376,0,168,3,4544,FALSE
North East And Yorkshire,16/09/2020,3,4379,0,168,3,4547,FALSE
North East And Yorkshire,17/09/2020,5,4384,1,169,6,4553,FALSE
North East And Yorkshire,18/09/2020,6,4390,0,169,6,4559,FALSE
North East And Yorkshire,19/09/2020,2,4392,0,169,2,4561,FALSE
North East And Yorkshire,20/09/2020,9,4401,0,169,9,4570,FALSE
North East And Yorkshire,21/09/2020,7,4408,0,169,7,4577,FALSE
North East And Yorkshire,22/09/2020,5,4413,0,169,5,4582,FALSE
North East And Yorkshire,23/09/2020,6,4419,0,169,6,4588,FALSE
North East And Yorkshire,24/09/2020,3,4422,1,170,4,4592,FALSE
North East And Yorkshire,25/09/2020,5,4427,0,170,5,4597,FALSE
North East And Yorkshire,26/09/2020,7,4434,0,170,7,4604,FALSE
North East And Yorkshire,27/09/2020,10,4444,1,171,11,4615,FALSE
North East And Yorkshire,28/09/2020,6,4450,0,171,6,4621,FALSE
North East And Yorkshire,29/09/2020,7,4457,1,172,8,4629,FALSE
North East And Yorkshire,30/09/2020,7,4464,0,172,7,4636,FALSE
North East And Yorkshire,01/10/2020,8,4472,0,172,8,4644,FALSE
North East And Yorkshire,02/10/2020,16,4488,0,172,16,4660,FALSE
North East And Yorkshire,03/10/2020,12,4500,0,172,12,4672,FALSE
North East And Yorkshire,04/10/2020,13,4513,1,173,14,4686,FALSE
North East And Yorkshire,05/10/2020,10,4523,0,173,10,4696,FALSE
North East And Yorkshire,06/10/2020,15,4538,0,173,15,4711,FALSE
North East And Yorkshire,07/10/2020,13,4551,1,174,14,4725,FALSE
North East And Yorkshire,08/10/2020,16,4567,2,176,18,4743,FALSE
North East And Yorkshire,09/10/2020,10,4577,2,178,12,4755,FALSE
North East And Yorkshire,10/10/2020,16,4593,1,179,17,4772,FALSE
North East And Yorkshire,11/10/2020,16,4609,0,179,16,4788,FALSE
North East And Yorkshire,12/10/2020,15,4624,0,179,15,4803,FALSE
North East And Yorkshire,13/10/2020,21,4645,0,179,21,4824,FALSE
North East And Yorkshire,14/10/2020,20,4665,1,180,21,4845,FALSE
North East And Yorkshire,15/10/2020,23,4688,0,180,23,4868,FALSE
North East And Yorkshire,16/10/2020,24,4712,1,181,25,4893,FALSE
North East And Yorkshire,17/10/2020,34,4746,1,182,35,4928,FALSE
North East And Yorkshire,18/10/2020,22,4768,2,184,24,4952,FALSE
North East And Yorkshire,19/10/2020,34,4802,0,184,34,4986,FALSE
North East And Yorkshire,20/10/2020,38,4840,2,186,40,5026,FALSE
North East And Yorkshire,21/10/2020,43,4883,2,188,45,5071,FALSE
North East And Yorkshire,22/10/2020,33,4916,1,189,34,5105,FALSE
North East And Yorkshire,23/10/2020,31,4947,1,190,32,5137,FALSE
North East And Yorkshire,24/10/2020,34,4981,3,193,37,5174,FALSE
North East And Yorkshire,25/10/2020,35,5016,0,193,35,5209,FALSE
North East And Yorkshire,26/10/2020,46,5062,2,195,48,5257,FALSE
North East And Yorkshire,27/10/2020,45,5107,0,195,45,5302,FALSE
North East And Yorkshire,28/10/2020,39,5146,0,195,39,5341,FALSE
North East And Yorkshire,29/10/2020,51,5197,2,197,53,5394,FALSE
North East And Yorkshire,30/10/2020,49,5246,0,197,49,5443,FALSE
North East And Yorkshire,31/10/2020,58,5304,5,202,63,5506,FALSE
North East And Yorkshire,01/11/2020,48,5352,0,202,48,5554,FALSE
North East And Yorkshire,02/11/2020,50,5402,3,205,53,5607,FALSE
North East And Yorkshire,03/11/2020,48,5450,3,208,51,5658,FALSE
North East And Yorkshire,04/11/2020,57,5507,3,211,60,5718,FALSE
North East And Yorkshire,05/11/2020,57,5564,3,214,60,5778,FALSE
North East And Yorkshire,06/11/2020,57,5621,3,217,60,5838,FALSE
North East And Yorkshire,07/11/2020,75,5696,3,220,78,5916,FALSE
North East And Yorkshire,08/11/2020,63,5759,2,222,65,5981,FALSE
North East And Yorkshire,09/11/2020,87,5846,2,224,89,6070,FALSE
North East And Yorkshire,10/11/2020,65,5911,5,229,70,6140,FALSE
North East And Yorkshire,11/11/2020,59,5970,2,231,61,6201,FALSE
North East And Yorkshire,12/11/2020,77,6047,1,232,78,6279,FALSE
North East And Yorkshire,13/11/2020,80,6127,2,234,82,6361,FALSE
North East And Yorkshire,14/11/2020,72,6199,1,235,73,6434,FALSE
North East And Yorkshire,15/11/2020,79,6278,2,237,81,6515,FALSE
North East And Yorkshire,16/11/2020,54,6332,1,238,55,6570,FALSE
North East And Yorkshire,17/11/2020,68,6400,0,238,68,6638,FALSE
North East And Yorkshire,18/11/2020,82,6482,6,244,88,6726,FALSE
North East And Yorkshire,19/11/2020,72,6554,1,245,73,6799,FALSE
North East And Yorkshire,20/11/2020,75,6629,2,247,77,6876,FALSE
North East And Yorkshire,21/11/2020,54,6683,4,251,58,6934,FALSE
North East And Yorkshire,22/11/2020,80,6763,2,253,82,7016,FALSE
North East And Yorkshire,23/11/2020,84,6847,5,258,89,7105,FALSE
North East And Yorkshire,24/11/2020,81,6928,1,259,82,7187,FALSE
North East And Yorkshire,25/11/2020,70,6998,5,264,75,7262,FALSE
North East And Yorkshire,26/11/2020,64,7062,5,269,69,7331,FALSE
North East And Yorkshire,27/11/2020,62,7124,2,271,64,7395,FALSE
North East And Yorkshire,28/11/2020,77,7201,3,274,80,7475,FALSE
North East And Yorkshire,29/11/2020,62,7263,0,274,62,7537,FALSE
North East And Yorkshire,30/11/2020,56,7319,4,278,60,7597,FALSE
North East And Yorkshire,01/12/2020,44,7363,2,280,46,7643,FALSE
North East And Yorkshire,02/12/2020,59,7422,3,283,62,7705,FALSE
North East And Yorkshire,03/12/2020,71,7493,6,289,77,7782,FALSE
North East And Yorkshire,04/12/2020,65,7558,5,294,70,7852,FALSE
North East And Yorkshire,05/12/2020,48,7606,3,297,51,7903,FALSE
North East And Yorkshire,06/12/2020,67,7673,4,301,71,7974,FALSE
North East And Yorkshire,07/12/2020,50,7723,2,303,52,8026,FALSE
North East And Yorkshire,08/12/2020,54,7777,1,304,55,8081,FALSE
North East And Yorkshire,09/12/2020,50,7827,1,305,51,8132,FALSE
North East And Yorkshire,10/12/2020,56,7883,2,307,58,8190,FALSE
North East And Yorkshire,11/12/2020,58,7941,5,312,63,8253,FALSE
North East And Yorkshire,12/12/2020,55,7996,1,313,56,8309,FALSE
North East And Yorkshire,13/12/2020,51,8047,5,318,56,8365,FALSE
North East And Yorkshire,14/12/2020,49,8096,3,321,52,8417,FALSE
North East And Yorkshire,15/12/2020,55,8151,2,323,57,8474,FALSE
North East And Yorkshire,16/12/2020,41,8192,0,323,41,8515,FALSE
North East And Yorkshire,17/12/2020,50,8242,6,329,56,8571,FALSE
North East And Yorkshire,18/12/2020,59,8301,5,334,64,8635,FALSE
North East And Yorkshire,19/12/2020,50,8351,2,336,52,8687,FALSE
North East And Yorkshire,20/12/2020,54,8405,4,340,58,8745,FALSE
North East And Yorkshire,21/12/2020,35,8440,7,347,42,8787,FALSE
North East And Yorkshire,22/12/2020,58,8498,9,356,67,8854,FALSE
North East And Yorkshire,23/12/2020,60,8558,3,359,63,8917,FALSE
North East And Yorkshire,24/12/2020,50,8608,2,361,52,8969,FALSE
North East And Yorkshire,25/12/2020,57,8665,4,365,61,9030,FALSE
North East And Yorkshire,26/12/2020,68,8733,2,367,70,9100,FALSE
North East And Yorkshire,27/12/2020,74,8807,7,374,81,9181,FALSE
North East And Yorkshire,28/12/2020,66,8873,5,379,71,9252,FALSE
North East And Yorkshire,29/12/2020,59,8932,6,385,65,9317,FALSE
North East And Yorkshire,30/12/2020,42,8974,3,388,45,9362,FALSE
North East And Yorkshire,31/12/2020,52,9026,5,393,57,9419,FALSE
North East And Yorkshire,01/01/2021,71,9097,2,395,73,9492,FALSE
North East And Yorkshire,02/01/2021,60,9157,2,397,62,9554,FALSE
North East And Yorkshire,03/01/2021,49,9206,4,401,53,9607,FALSE
North East And Yorkshire,04/01/2021,65,9271,4,405,69,9676,FALSE
North East And Yorkshire,05/01/2021,65,9336,1,406,66,9742,FALSE
North East And Yorkshire,06/01/2021,61,9397,2,408,63,9805,FALSE
North East And Yorkshire,07/01/2021,73,9470,5,413,78,9883,FALSE
North East And Yorkshire,08/01/2021,68,9538,6,419,74,9957,FALSE
North East And Yorkshire,09/01/2021,58,9596,1,420,59,10016,FALSE
North East And Yorkshire,10/01/2021,82,9678,2,422,84,10100,FALSE
North East And Yorkshire,11/01/2021,83,9761,1,423,84,10184,FALSE
North East And Yorkshire,12/01/2021,69,9830,6,429,75,10259,FALSE
North East And Yorkshire,13/01/2021,77,9907,6,435,83,10342,FALSE
North East And Yorkshire,14/01/2021,71,9978,5,440,76,10418,FALSE
North East And Yorkshire,15/01/2021,97,10075,6,446,103,10521,FALSE
North East And Yorkshire,16/01/2021,100,10175,3,449,103,10624,FALSE
North East And Yorkshire,17/01/2021,76,10251,3,452,79,10703,FALSE
North East And Yorkshire,18/01/2021,84,10335,4,456,88,10791,FALSE
North East And Yorkshire,19/01/2021,104,10439,7,463,111,10902,FALSE
North East And Yorkshire,20/01/2021,92,10531,5,468,97,10999,FALSE
North East And Yorkshire,21/01/2021,87,10618,5,473,92,11091,FALSE
North East And Yorkshire,22/01/2021,80,10698,3,476,83,11174,FALSE
North East And Yorkshire,23/01/2021,70,10768,7,483,77,11251,FALSE
North East And Yorkshire,24/01/2021,64,10832,3,486,67,11318,FALSE
North East And Yorkshire,25/01/2021,79,10911,4,490,83,11401,FALSE
North East And Yorkshire,26/01/2021,73,10984,4,494,77,11478,FALSE
North East And Yorkshire,27/01/2021,71,11055,3,497,74,11552,FALSE
North East And Yorkshire,28/01/2021,73,11128,5,502,78,11630,FALSE
North East And Yorkshire,29/01/2021,85,11213,4,506,89,11719,FALSE
North East And Yorkshire,30/01/2021,76,11289,4,510,80,11799,FALSE
North East And Yorkshire,31/01/2021,83,11372,6,516,89,11888,FALSE
North East And Yorkshire,01/02/2021,79,11451,5,521,84,11972,FALSE
North East And Yorkshire,02/02/2021,71,11522,6,527,77,12049,FALSE
North East And Yorkshire,03/02/2021,83,11605,1,528,84,12133,FALSE
North East And Yorkshire,04/02/2021,70,11675,6,534,76,12209,FALSE
North East And Yorkshire,05/02/2021,81,11756,4,538,85,12294,FALSE
North East And Yorkshire,06/02/2021,52,11808,2,540,54,12348,FALSE
North East And Yorkshire,07/02/2021,59,11867,3,543,62,12410,FALSE
North East And Yorkshire,08/02/2021,53,11920,3,546,56,12466,FALSE
North East And Yorkshire,09/02/2021,54,11974,6,552,60,12526,FALSE
North East And Yorkshire,10/02/2021,62,12036,3,555,65,12591,FALSE
North East And Yorkshire,11/02/2021,67,12103,6,561,73,12664,FALSE
North East And Yorkshire,12/02/2021,60,12163,8,569,68,12732,FALSE
North East And Yorkshire,13/02/2021,54,12217,5,574,59,12791,FALSE
North East And Yorkshire,14/02/2021,60,12277,5,579,65,12856,FALSE
North East And Yorkshire,15/02/2021,62,12339,5,584,67,12923,FALSE
North East And Yorkshire,16/02/2021,50,12389,3,587,53,12976,FALSE
North East And Yorkshire,17/02/2021,50,12439,4,591,54,13030,FALSE
North East And Yorkshire,18/02/2021,48,12487,4,595,52,13082,FALSE
North East And Yorkshire,19/02/2021,45,12532,1,596,46,13128,FALSE
North East And Yorkshire,20/02/2021,39,12571,3,599,42,13170,FALSE
North East And Yorkshire,21/02/2021,40,12611,6,605,46,13216,FALSE
North East And Yorkshire,22/02/2021,21,12632,5,610,26,13242,FALSE
North East And Yorkshire,23/02/2021,39,12671,2,612,41,13283,FALSE
North East And Yorkshire,24/02/2021,35,12706,1,613,36,13319,FALSE
North East And Yorkshire,25/02/2021,30,12736,3,616,33,13352,FALSE
North East And Yorkshire,26/02/2021,26,12762,5,621,31,13383,FALSE
North East And Yorkshire,27/02/2021,32,12794,4,625,36,13419,FALSE
North East And Yorkshire,28/02/2021,29,12823,3,628,32,13451,FALSE
North East And Yorkshire,01/03/2021,20,12843,6,634,26,13477,FALSE
North East And Yorkshire,02/03/2021,17,12860,3,637,20,13497,FALSE
North East And Yorkshire,03/03/2021,28,12888,4,641,32,13529,FALSE
North East And Yorkshire,04/03/2021,18,12906,4,645,22,13551,FALSE
North East And Yorkshire,05/03/2021,28,12934,4,649,32,13583,FALSE
North East And Yorkshire,06/03/2021,25,12959,6,655,31,13614,FALSE
North East And Yorkshire,07/03/2021,19,12978,3,658,22,13636,FALSE
North East And Yorkshire,08/03/2021,20,12998,4,662,24,13660,FALSE
North East And Yorkshire,09/03/2021,23,13021,2,664,25,13685,FALSE
North East And Yorkshire,10/03/2021,16,13037,3,667,19,13704,FALSE
North East And Yorkshire,11/03/2021,15,13052,1,668,16,13720,FALSE
North East And Yorkshire,12/03/2021,16,13068,3,671,19,13739,FALSE
North East And Yorkshire,13/03/2021,14,13082,2,673,16,13755,FALSE
North East And Yorkshire,14/03/2021,12,13094,2,675,14,13769,FALSE
North East And Yorkshire,15/03/2021,14,13108,2,677,16,13785,FALSE
North East And Yorkshire,16/03/2021,11,13119,3,680,14,13799,FALSE
North East And Yorkshire,17/03/2021,9,13128,3,683,12,13811,FALSE
North East And Yorkshire,18/03/2021,10,13138,1,684,11,13822,FALSE
North East And Yorkshire,19/03/2021,7,13145,2,686,9,13831,FALSE
North East And Yorkshire,20/03/2021,10,13155,4,690,14,13845,FALSE
North East And Yorkshire,21/03/2021,10,13165,1,691,11,13856,FALSE
North East And Yorkshire,22/03/2021,7,13172,1,692,8,13864,FALSE
North East And Yorkshire,23/03/2021,14,13186,2,694,16,13880,FALSE
North East And Yorkshire,24/03/2021,4,13190,0,694,4,13884,FALSE
North East And Yorkshire,25/03/2021,7,13197,0,694,7,13891,FALSE
North East And Yorkshire,26/03/2021,10,13207,2,696,12,13903,FALSE
North East And Yorkshire,27/03/2021,3,13210,3,699,6,13909,FALSE
North East And Yorkshire,28/03/2021,4,13214,1,700,5,13914,FALSE
North East And Yorkshire,29/03/2021,6,13220,4,704,10,13924,FALSE
North East And Yorkshire,30/03/2021,7,13227,0,704,7,13931,FALSE
North East And Yorkshire,31/03/2021,8,13235,0,704,8,13939,FALSE
North East And Yorkshire,01/04/2021,5,13240,0,704,5,13944,FALSE
North East And Yorkshire,02/04/2021,3,13243,0,704,3,13947,FALSE
North East And Yorkshire,03/04/2021,4,13247,0,704,4,13951,FALSE
North East And Yorkshire,04/04/2021,4,13251,2,706,6,13957,FALSE
North East And Yorkshire,05/04/2021,2,13253,0,706,2,13959,FALSE
North East And Yorkshire,06/04/2021,6,13259,0,706,6,13965,FALSE
North East And Yorkshire,07/04/2021,6,13265,0,706,6,13971,FALSE
North East And Yorkshire,08/04/2021,8,13273,3,709,11,13982,FALSE
North East And Yorkshire,09/04/2021,4,13277,1,710,5,13987,FALSE
North East And Yorkshire,10/04/2021,4,13281,0,710,4,13991,FALSE
North East And Yorkshire,11/04/2021,5,13286,0,710,5,13996,FALSE
North East And Yorkshire,12/04/2021,9,13295,0,710,9,14005,FALSE
North East And Yorkshire,13/04/2021,4,13299,4,714,8,14013,FALSE
North East And Yorkshire,14/04/2021,4,13303,0,714,4,14017,FALSE
North East And Yorkshire,15/04/2021,8,13311,0,714,8,14025,FALSE
North East And Yorkshire,16/04/2021,3,13314,1,715,4,14029,FALSE
North East And Yorkshire,17/04/2021,5,13319,2,717,7,14036,FALSE
North East And Yorkshire,18/04/2021,1,13320,0,717,1,14037,FALSE
North East And Yorkshire,19/04/2021,1,13321,1,718,2,14039,FALSE
North East And Yorkshire,20/04/2021,6,13327,0,718,6,14045,FALSE
North East And Yorkshire,21/04/2021,4,13331,1,719,5,14050,FALSE
North East And Yorkshire,22/04/2021,3,13334,1,720,4,14054,FALSE
North East And Yorkshire,23/04/2021,1,13335,0,720,1,14055,FALSE
North East And Yorkshire,24/04/2021,0,13335,2,722,2,14057,FALSE
North East And Yorkshire,25/04/2021,2,13337,0,722,2,14059,FALSE
North East And Yorkshire,26/04/2021,1,13338,0,722,1,14060,FALSE
North East And Yorkshire,27/04/2021,2,13340,0,722,2,14062,FALSE
North East And Yorkshire,28/04/2021,2,13342,1,723,3,14065,FALSE
North East And Yorkshire,29/04/2021,0,13342,0,723,0,14065,FALSE
North East And Yorkshire,30/04/2021,3,13345,0,723,3,14068,FALSE
North East And Yorkshire,01/05/2021,2,13347,0,723,2,14070,FALSE
North East And Yorkshire,02/05/2021,3,13350,0,723,3,14073,FALSE
North East And Yorkshire,03/05/2021,2,13352,0,723,2,14075,FALSE
North East And Yorkshire,04/05/2021,2,13354,0,723,2,14077,FALSE
North East And Yorkshire,05/05/2021,5,13359,1,724,6,14083,FALSE
North East And Yorkshire,06/05/2021,0,13359,1,725,1,14084,FALSE
North East And Yorkshire,07/05/2021,3,13362,0,725,3,14087,FALSE
North East And Yorkshire,08/05/2021,3,13365,0,725,3,14090,FALSE
North East And Yorkshire,09/05/2021,2,13367,1,726,3,14093,FALSE
North East And Yorkshire,10/05/2021,0,13367,0,726,0,14093,FALSE
North East And Yorkshire,11/05/2021,2,13369,0,726,2,14095,FALSE
North East And Yorkshire,12/05/2021,5,13374,3,729,8,14103,FALSE
North East And Yorkshire,13/05/2021,1,13375,0,729,1,14104,FALSE
North East And Yorkshire,14/05/2021,0,13375,0,729,0,14104,FALSE
North East And Yorkshire,15/05/2021,1,13376,1,730,2,14106,FALSE
North East And Yorkshire,16/05/2021,1,13377,0,730,1,14107,FALSE
North East And Yorkshire,17/05/2021,1,13378,1,731,2,14109,FALSE
North East And Yorkshire,18/05/2021,0,13378,1,732,1,14110,FALSE
North East And Yorkshire,19/05/2021,1,13379,0,732,1,14111,FALSE
North East And Yorkshire,20/05/2021,0,13379,0,732,0,14111,FALSE
North East And Yorkshire,21/05/2021,1,13380,0,732,1,14112,FALSE
North East And Yorkshire,22/05/2021,0,13380,0,732,0,14112,FALSE
North East And Yorkshire,23/05/2021,0,13380,0,732,0,14112,FALSE
North East And Yorkshire,24/05/2021,1,13381,0,732,1,14113,FALSE
North East And Yorkshire,25/05/2021,0,13381,0,732,0,14113,FALSE
North East And Yorkshire,26/05/2021,2,13383,0,732,2,14115,FALSE
North East And Yorkshire,27/05/2021,0,13383,0,732,0,14115,FALSE
North East And Yorkshire,28/05/2021,2,13385,0,732,2,14117,FALSE
North East And Yorkshire,29/05/2021,0,13385,0,732,0,14117,FALSE
North East And Yorkshire,30/05/2021,1,13386,1,733,2,14119,FALSE
North East And Yorkshire,31/05/2021,1,13387,0,733,1,14120,FALSE
North East And Yorkshire,01/06/2021,0,13387,0,733,0,14120,FALSE
North East And Yorkshire,02/06/2021,2,13389,0,733,2,14122,FALSE
North East And Yorkshire,03/06/2021,0,13389,1,734,1,14123,FALSE
North East And Yorkshire,04/06/2021,0,13389,1,735,1,14124,FALSE
North East And Yorkshire,05/06/2021,1,13390,0,735,1,14125,FALSE
North East And Yorkshire,06/06/2021,1,13391,1,736,2,14127,FALSE
North East And Yorkshire,07/06/2021,0,13391,0,736,0,14127,FALSE
North East And Yorkshire,08/06/2021,1,13392,0,736,1,14128,FALSE
North East And Yorkshire,09/06/2021,0,13392,0,736,0,14128,FALSE
North East And Yorkshire,10/06/2021,1,13393,0,736,1,14129,FALSE
North East And Yorkshire,11/06/2021,2,13395,1,737,3,14132,FALSE
North East And Yorkshire,12/06/2021,0,13395,0,737,0,14132,FALSE
North East And Yorkshire,13/06/2021,1,13396,0,737,1,14133,FALSE
North East And Yorkshire,14/06/2021,0,13396,0,737,0,14133,FALSE
North East And Yorkshire,15/06/2021,2,13398,0,737,2,14135,FALSE
North East And Yorkshire,16/06/2021,0,13398,0,737,0,14135,FALSE
North East And Yorkshire,17/06/2021,0,13398,0,737,0,14135,FALSE
North East And Yorkshire,18/06/2021,0,13398,0,737,0,14135,FALSE
North East And Yorkshire,19/06/2021,2,13400,0,737,2,14137,FALSE
North East And Yorkshire,20/06/2021,3,13403,0,737,3,14140,FALSE
North East And Yorkshire,21/06/2021,2,13405,0,737,2,14142,FALSE
North East And Yorkshire,22/06/2021,3,13408,0,737,3,14145,FALSE
North East And Yorkshire,23/06/2021,0,13408,0,737,0,14145,FALSE
North East And Yorkshire,24/06/2021,2,13410,0,737,2,14147,FALSE
North East And Yorkshire,25/06/2021,0,13410,0,737,0,14147,FALSE
North East And Yorkshire,26/06/2021,1,13411,0,737,1,14148,FALSE
North East And Yorkshire,27/06/2021,4,13415,1,738,5,14153,FALSE
North East And Yorkshire,28/06/2021,3,13418,0,738,3,14156,FALSE
North East And Yorkshire,29/06/2021,3,13421,0,738,3,14159,FALSE
North East And Yorkshire,30/06/2021,1,13422,0,738,1,14160,FALSE
North East And Yorkshire,01/07/2021,5,13427,0,738,5,14165,FALSE
North East And Yorkshire,02/07/2021,2,13429,0,738,2,14167,FALSE
North East And Yorkshire,03/07/2021,5,13434,1,739,6,14173,FALSE
North East And Yorkshire,04/07/2021,1,13435,0,739,1,14174,FALSE
North East And Yorkshire,05/07/2021,0,13435,0,739,0,14174,FALSE
North East And Yorkshire,06/07/2021,4,13439,0,739,4,14178,FALSE
North East And Yorkshire,07/07/2021,2,13441,0,739,2,14180,FALSE
North East And Yorkshire,08/07/2021,5,13446,0,739,5,14185,FALSE
North East And Yorkshire,09/07/2021,7,13453,0,739,7,14192,FALSE
North East And Yorkshire,10/07/2021,3,13456,0,739,3,14195,FALSE
North East And Yorkshire,11/07/2021,5,13461,0,739,5,14200,FALSE
North East And Yorkshire,12/07/2021,2,13463,0,739,2,14202,FALSE
North East And Yorkshire,13/07/2021,12,13475,0,739,12,14214,FALSE
North East And Yorkshire,14/07/2021,8,13483,0,739,8,14222,FALSE
North East And Yorkshire,15/07/2021,11,13494,0,739,11,14233,FALSE
North East And Yorkshire,16/07/2021,8,13502,0,739,8,14241,FALSE
North East And Yorkshire,17/07/2021,6,13508,0,739,6,14247,FALSE
North East And Yorkshire,18/07/2021,12,13520,0,739,12,14259,FALSE
North East And Yorkshire,19/07/2021,19,13539,2,741,21,14280,FALSE
North East And Yorkshire,20/07/2021,12,13551,0,741,12,14292,FALSE
North East And Yorkshire,21/07/2021,11,13562,0,741,11,14303,FALSE
North East And Yorkshire,22/07/2021,7,13569,1,742,8,14311,FALSE
North East And Yorkshire,23/07/2021,12,13581,0,742,12,14323,FALSE
North East And Yorkshire,24/07/2021,13,13594,0,742,13,14336,FALSE
North East And Yorkshire,25/07/2021,12,13606,0,742,12,14348,FALSE
North East And Yorkshire,26/07/2021,16,13622,0,742,16,14364,FALSE
North East And Yorkshire,27/07/2021,12,13634,1,743,13,14377,FALSE
North East And Yorkshire,28/07/2021,18,13652,0,743,18,14395,FALSE
North East And Yorkshire,29/07/2021,16,13668,0,743,16,14411,FALSE
North East And Yorkshire,30/07/2021,13,13681,1,744,14,14425,FALSE
North East And Yorkshire,31/07/2021,16,13697,2,746,18,14443,FALSE
North East And Yorkshire,01/08/2021,10,13707,1,747,11,14454,FALSE
North East And Yorkshire,02/08/2021,13,13720,0,747,13,14467,FALSE
North East And Yorkshire,03/08/2021,17,13737,0,747,17,14484,FALSE
North East And Yorkshire,04/08/2021,10,13747,1,748,11,14495,FALSE
North East And Yorkshire,05/08/2021,25,13772,0,748,25,14520,FALSE
North East And Yorkshire,06/08/2021,16,13788,0,748,16,14536,FALSE
North East And Yorkshire,07/08/2021,16,13804,0,748,16,14552,FALSE
North East And Yorkshire,08/08/2021,14,13818,0,748,14,14566,FALSE
North East And Yorkshire,09/08/2021,13,13831,0,748,13,14579,FALSE
North East And Yorkshire,10/08/2021,15,13846,0,748,15,14594,FALSE
North East And Yorkshire,11/08/2021,15,13861,0,748,15,14609,FALSE
North East And Yorkshire,12/08/2021,20,13881,0,748,20,14629,FALSE
North East And Yorkshire,13/08/2021,14,13895,1,749,15,14644,FALSE
North East And Yorkshire,14/08/2021,16,13911,3,752,19,14663,FALSE
North East And Yorkshire,15/08/2021,12,13923,1,753,13,14676,FALSE
North East And Yorkshire,16/08/2021,13,13936,0,753,13,14689,FALSE
North East And Yorkshire,17/08/2021,14,13950,1,754,15,14704,FALSE
North East And Yorkshire,18/08/2021,15,13965,1,755,16,14720,FALSE
North East And Yorkshire,19/08/2021,17,13982,0,755,17,14737,FALSE
North East And Yorkshire,20/08/2021,18,14000,0,755,18,14755,FALSE
North East And Yorkshire,21/08/2021,15,14015,1,756,16,14771,FALSE
North East And Yorkshire,22/08/2021,17,14032,2,758,19,14790,FALSE
North East And Yorkshire,23/08/2021,16,14048,1,759,17,14807,FALSE
North East And Yorkshire,24/08/2021,20,14068,0,759,20,14827,FALSE
North East And Yorkshire,25/08/2021,9,14077,0,759,9,14836,FALSE
North East And Yorkshire,26/08/2021,8,14085,0,759,8,14844,FALSE
North East And Yorkshire,27/08/2021,22,14107,1,760,23,14867,FALSE
North East And Yorkshire,28/08/2021,17,14124,1,761,18,14885,FALSE
North East And Yorkshire,29/08/2021,19,14143,2,763,21,14906,FALSE
North East And Yorkshire,30/08/2021,13,14156,3,766,16,14922,FALSE
North East And Yorkshire,31/08/2021,25,14181,2,768,27,14949,FALSE
North East And Yorkshire,01/09/2021,15,14196,0,768,15,14964,FALSE
North East And Yorkshire,02/09/2021,14,14210,1,769,15,14979,FALSE
North East And Yorkshire,03/09/2021,22,14232,1,770,23,15002,FALSE
North East And Yorkshire,04/09/2021,17,14249,0,770,17,15019,FALSE
North East And Yorkshire,05/09/2021,23,14272,1,771,24,15043,FALSE
North East And Yorkshire,06/09/2021,20,14292,0,771,20,15063,FALSE
North East And Yorkshire,07/09/2021,12,14304,1,772,13,15076,FALSE
North East And Yorkshire,08/09/2021,16,14320,0,772,16,15092,FALSE
North East And Yorkshire,09/09/2021,22,14342,1,773,23,15115,FALSE
North East And Yorkshire,10/09/2021,27,14369,1,774,28,15143,FALSE
North East And Yorkshire,11/09/2021,14,14383,1,775,15,15158,FALSE
North East And Yorkshire,12/09/2021,17,14400,0,775,17,15175,FALSE
North East And Yorkshire,13/09/2021,12,14412,1,776,13,15188,FALSE
North East And Yorkshire,14/09/2021,23,14435,2,778,25,15213,FALSE
North East And Yorkshire,15/09/2021,19,14454,3,781,22,15235,FALSE
North East And Yorkshire,16/09/2021,26,14480,0,781,26,15261,FALSE
North East And Yorkshire,17/09/2021,16,14496,1,782,17,15278,FALSE
North East And Yorkshire,18/09/2021,10,14506,2,784,12,15290,FALSE
North East And Yorkshire,19/09/2021,20,14526,2,786,22,15312,FALSE
North East And Yorkshire,20/09/2021,27,14553,0,786,27,15339,FALSE
North East And Yorkshire,21/09/2021,16,14569,1,787,17,15356,FALSE
North East And Yorkshire,22/09/2021,20,14589,0,787,20,15376,FALSE
North East And Yorkshire,23/09/2021,14,14603,3,790,17,15393,FALSE
North East And Yorkshire,24/09/2021,22,14625,2,792,24,15417,FALSE
North East And Yorkshire,25/09/2021,12,14637,1,793,13,15430,FALSE
North East And Yorkshire,26/09/2021,15,14652,1,794,16,15446,FALSE
North East And Yorkshire,27/09/2021,11,14663,3,797,14,15460,FALSE
North East And Yorkshire,28/09/2021,11,14674,1,798,12,15472,FALSE
North East And Yorkshire,29/09/2021,23,14697,1,799,24,15496,FALSE
North East And Yorkshire,30/09/2021,14,14711,5,804,19,15515,FALSE
North East And Yorkshire,01/10/2021,15,14726,1,805,16,15531,FALSE
North East And Yorkshire,02/10/2021,12,14738,1,806,13,15544,FALSE
North East And Yorkshire,03/10/2021,17,14755,0,806,17,15561,FALSE
North East And Yorkshire,04/10/2021,10,14765,4,810,14,15575,FALSE
North East And Yorkshire,05/10/2021,9,14774,1,811,10,15585,FALSE
North East And Yorkshire,06/10/2021,12,14786,0,811,12,15597,FALSE
North East And Yorkshire,07/10/2021,18,14804,0,811,18,15615,FALSE
North East And Yorkshire,08/10/2021,23,14827,1,812,24,15639,FALSE
North East And Yorkshire,09/10/2021,13,14840,2,814,15,15654,FALSE
North East And Yorkshire,10/10/2021,10,14850,2,816,12,15666,FALSE
North East And Yorkshire,11/10/2021,16,14866,0,816,16,15682,FALSE
North East And Yorkshire,12/10/2021,18,14884,2,818,20,15702,FALSE
North East And Yorkshire,13/10/2021,25,14909,2,820,27,15729,FALSE
North East And Yorkshire,14/10/2021,21,14930,1,821,22,15751,FALSE
North East And Yorkshire,15/10/2021,26,14956,0,821,26,15777,FALSE
North East And Yorkshire,16/10/2021,20,14976,1,822,21,15798,FALSE
North East And Yorkshire,17/10/2021,15,14991,1,823,16,15814,FALSE
North East And Yorkshire,18/10/2021,15,15006,0,823,15,15829,FALSE
North East And Yorkshire,19/10/2021,19,15025,1,824,20,15849,FALSE
North East And Yorkshire,20/10/2021,26,15051,1,825,27,15876,FALSE
North East And Yorkshire,21/10/2021,20,15071,1,826,21,15897,FALSE
North East And Yorkshire,22/10/2021,24,15095,0,826,24,15921,FALSE
North East And Yorkshire,23/10/2021,21,15116,2,828,23,15944,FALSE
North East And Yorkshire,24/10/2021,22,15138,2,830,24,15968,FALSE
North East And Yorkshire,25/10/2021,23,15161,1,831,24,15992,FALSE
North East And Yorkshire,26/10/2021,15,15176,3,834,18,16010,FALSE
North East And Yorkshire,27/10/2021,29,15205,0,834,29,16039,FALSE
North East And Yorkshire,28/10/2021,22,15227,3,837,25,16064,FALSE
North East And Yorkshire,29/10/2021,14,15241,1,838,15,16079,FALSE
North East And Yorkshire,30/10/2021,24,15265,3,841,27,16106,FALSE
North East And Yorkshire,31/10/2021,29,15294,0,841,29,16135,FALSE
North East And Yorkshire,01/11/2021,17,15311,0,841,17,16152,FALSE
North East And Yorkshire,02/11/2021,28,15339,0,841,28,16180,FALSE
North East And Yorkshire,03/11/2021,23,15362,3,844,26,16206,FALSE
North East And Yorkshire,04/11/2021,22,15384,3,847,25,16231,FALSE
North East And Yorkshire,05/11/2021,20,15404,1,848,21,16252,FALSE
North East And Yorkshire,06/11/2021,21,15425,2,850,23,16275,FALSE
North East And Yorkshire,07/11/2021,22,15447,0,850,22,16297,FALSE
North East And Yorkshire,08/11/2021,16,15463,0,850,16,16313,FALSE
North East And Yorkshire,09/11/2021,18,15481,2,852,20,16333,FALSE
North East And Yorkshire,10/11/2021,17,15498,1,853,18,16351,FALSE
North East And Yorkshire,11/11/2021,25,15523,0,853,25,16376,FALSE
North East And Yorkshire,12/11/2021,18,15541,1,854,19,16395,FALSE
North East And Yorkshire,13/11/2021,18,15559,4,858,22,16417,FALSE
North East And Yorkshire,14/11/2021,16,15575,2,860,18,16435,FALSE
North East And Yorkshire,15/11/2021,16,15591,0,860,16,16451,FALSE
North East And Yorkshire,16/11/2021,17,15608,1,861,18,16469,FALSE
North East And Yorkshire,17/11/2021,12,15620,0,861,12,16481,FALSE
North East And Yorkshire,18/11/2021,22,15642,2,863,24,16505,FALSE
North East And Yorkshire,19/11/2021,16,15658,1,864,17,16522,FALSE
North East And Yorkshire,20/11/2021,15,15673,1,865,16,16538,FALSE
North East And Yorkshire,21/11/2021,14,15687,1,866,15,16553,FALSE
North East And Yorkshire,22/11/2021,16,15703,0,866,16,16569,FALSE
North East And Yorkshire,23/11/2021,13,15716,2,868,15,16584,FALSE
North East And Yorkshire,24/11/2021,19,15735,4,872,23,16607,FALSE
North East And Yorkshire,25/11/2021,20,15755,0,872,20,16627,FALSE
North East And Yorkshire,26/11/2021,18,15773,2,874,20,16647,FALSE
North East And Yorkshire,27/11/2021,11,15784,0,874,11,16658,FALSE
North East And Yorkshire,28/11/2021,15,15799,1,875,16,16674,FALSE
North East And Yorkshire,29/11/2021,16,15815,2,877,18,16692,FALSE
North East And Yorkshire,30/11/2021,9,15824,2,879,11,16703,FALSE
North East And Yorkshire,01/12/2021,17,15841,1,880,18,16721,FALSE
North East And Yorkshire,02/12/2021,13,15854,1,881,14,16735,FALSE
North East And Yorkshire,03/12/2021,21,15875,2,883,23,16758,FALSE
North East And Yorkshire,04/12/2021,20,15895,2,885,22,16780,FALSE
North East And Yorkshire,05/12/2021,17,15912,1,886,18,16798,FALSE
North East And Yorkshire,06/12/2021,13,15925,3,889,16,16814,FALSE
North East And Yorkshire,07/12/2021,14,15939,1,890,15,16829,FALSE
North East And Yorkshire,08/12/2021,14,15953,2,892,16,16845,FALSE
North East And Yorkshire,09/12/2021,9,15962,1,893,10,16855,FALSE
North East And Yorkshire,10/12/2021,12,15974,2,895,14,16869,FALSE
North East And Yorkshire,11/12/2021,12,15986,0,895,12,16881,FALSE
North East And Yorkshire,12/12/2021,16,16002,2,897,18,16899,FALSE
North East And Yorkshire,13/12/2021,17,16019,0,897,17,16916,FALSE
North East And Yorkshire,14/12/2021,7,16026,2,899,9,16925,FALSE
North East And Yorkshire,15/12/2021,9,16035,0,899,9,16934,FALSE
North East And Yorkshire,16/12/2021,10,16045,0,899,10,16944,FALSE
North East And Yorkshire,17/12/2021,16,16061,1,900,17,16961,FALSE
North East And Yorkshire,18/12/2021,7,16068,5,905,12,16973,FALSE
North East And Yorkshire,19/12/2021,10,16078,0,905,10,16983,FALSE
North East And Yorkshire,20/12/2021,17,16095,0,905,17,17000,FALSE
North East And Yorkshire,21/12/2021,10,16105,0,905,10,17010,FALSE
North East And Yorkshire,22/12/2021,16,16121,0,905,16,17026,FALSE
North East And Yorkshire,23/12/2021,9,16130,2,907,11,17037,FALSE
North East And Yorkshire,24/12/2021,9,16139,1,908,10,17047,FALSE
North East And Yorkshire,25/12/2021,16,16155,3,911,19,17066,FALSE
North East And Yorkshire,26/12/2021,16,16171,2,913,18,17084,FALSE
North East And Yorkshire,27/12/2021,9,16180,0,913,9,17093,FALSE
North East And Yorkshire,28/12/2021,18,16198,0,913,18,17111,FALSE
North East And Yorkshire,29/12/2021,7,16205,1,914,8,17119,FALSE
North East And Yorkshire,30/12/2021,17,16222,0,914,17,17136,FALSE
North East And Yorkshire,31/12/2021,13,16235,2,916,15,17151,FALSE
North East And Yorkshire,01/01/2022,18,16253,1,917,19,17170,FALSE
North East And Yorkshire,02/01/2022,10,16263,1,918,11,17181,FALSE
North East And Yorkshire,03/01/2022,17,16280,2,920,19,17200,FALSE
North East And Yorkshire,04/01/2022,13,16293,1,921,14,17214,FALSE
North East And Yorkshire,05/01/2022,16,16309,0,921,16,17230,FALSE
North East And Yorkshire,06/01/2022,23,16332,0,921,23,17253,FALSE
North East And Yorkshire,07/01/2022,28,16360,1,922,29,17282,FALSE
North East And Yorkshire,08/01/2022,24,16384,0,922,24,17306,FALSE
North East And Yorkshire,09/01/2022,20,16404,1,923,21,17327,FALSE
North East And Yorkshire,10/01/2022,31,16435,0,923,31,17358,FALSE
North East And Yorkshire,11/01/2022,31,16466,1,924,32,17390,FALSE
North East And Yorkshire,12/01/2022,36,16502,0,924,36,17426,FALSE
North East And Yorkshire,13/01/2022,25,16527,0,924,25,17451,FALSE
North East And Yorkshire,14/01/2022,28,16555,0,924,28,17479,FALSE
North East And Yorkshire,15/01/2022,27,16582,1,925,28,17507,FALSE
North East And Yorkshire,16/01/2022,38,16620,1,926,39,17546,FALSE
North East And Yorkshire,17/01/2022,32,16652,1,927,33,17579,FALSE
North East And Yorkshire,18/01/2022,25,16677,0,927,25,17604,FALSE
North East And Yorkshire,19/01/2022,29,16706,0,927,29,17633,FALSE
North East And Yorkshire,20/01/2022,23,16729,1,928,24,17657,FALSE
North East And Yorkshire,21/01/2022,30,16759,0,928,30,17687,FALSE
North East And Yorkshire,22/01/2022,33,16792,1,929,34,17721,FALSE
North East And Yorkshire,23/01/2022,32,16824,0,929,32,17753,FALSE
North East And Yorkshire,24/01/2022,28,16852,0,929,28,17781,FALSE
North East And Yorkshire,25/01/2022,24,16876,1,930,25,17806,FALSE
North East And Yorkshire,26/01/2022,33,16909,1,931,34,17840,FALSE
North East And Yorkshire,27/01/2022,30,16939,0,931,30,17870,FALSE
North East And Yorkshire,28/01/2022,33,16972,1,932,34,17904,FALSE
North East And Yorkshire,29/01/2022,21,16993,0,932,21,17925,FALSE
North East And Yorkshire,30/01/2022,23,17016,0,932,23,17948,FALSE
North East And Yorkshire,31/01/2022,33,17049,2,934,35,17983,FALSE
North East And Yorkshire,01/02/2022,24,17073,0,934,24,18007,FALSE
North East And Yorkshire,02/02/2022,11,17084,0,934,11,18018,TRUE
North East And Yorkshire,03/02/2022,15,17099,0,934,15,18033,TRUE
North East And Yorkshire,04/02/2022,3,17102,0,934,3,18036,TRUE
North East And Yorkshire,05/02/2022,0,17102,0,934,0,18036,TRUE
North East And Yorkshire,06/02/2022,0,17102,0,934,0,18036,TRUE
