nhs_england_region,date,new_deaths_with_positive_test,cumulative_deaths_with_positive_test,new_deaths_without_positive_test,cumulative_deaths_without_positive_test,new_deaths_total,cumulative_deaths_total,data_subject_to_change
London,29/02/2020,0,0,0,0,0,0,FALSE
London,01/03/2020,0,0,0,0,0,0,FALSE
London,02/03/2020,0,0,0,0,0,0,FALSE
London,03/03/2020,0,0,0,0,0,0,FALSE
London,04/03/2020,0,0,0,0,0,0,FALSE
London,05/03/2020,0,0,0,0,0,0,FALSE
London,06/03/2020,1,1,0,0,1,1,FALSE
London,07/03/2020,0,1,0,0,0,1,FALSE
London,08/03/2020,0,1,0,0,0,1,FALSE
London,09/03/2020,1,2,0,0,1,2,FALSE
London,10/03/2020,0,2,0,0,0,2,FALSE
London,11/03/2020,5,7,0,0,5,7,FALSE
London,12/03/2020,6,13,0,0,6,13,FALSE
London,13/03/2020,10,23,0,0,10,23,FALSE
London,14/03/2020,13,36,0,0,13,36,FALSE
London,15/03/2020,9,45,0,0,9,45,FALSE
London,16/03/2020,15,60,0,0,15,60,FALSE
London,17/03/2020,23,83,0,0,23,83,FALSE
London,18/03/2020,28,111,0,0,28,111,FALSE
London,19/03/2020,25,136,0,0,25,136,FALSE
London,20/03/2020,44,180,0,0,44,180,FALSE
London,21/03/2020,49,229,0,0,49,229,FALSE
London,22/03/2020,54,283,0,0,54,283,FALSE
London,23/03/2020,63,346,0,0,63,346,FALSE
London,24/03/2020,86,432,0,0,86,432,FALSE
London,25/03/2020,112,544,0,0,112,544,FALSE
London,26/03/2020,130,674,0,0,130,674,FALSE
London,27/03/2020,130,804,0,0,130,804,FALSE
London,28/03/2020,123,927,0,0,123,927,FALSE
London,29/03/2020,145,1072,0,0,145,1072,FALSE
London,30/03/2020,151,1223,0,0,151,1223,FALSE
London,31/03/2020,183,1406,0,0,183,1406,FALSE
London,01/04/2020,202,1608,0,0,202,1608,FALSE
London,02/04/2020,190,1798,0,0,190,1798,FALSE
London,03/04/2020,199,1997,0,0,199,1997,FALSE
London,04/04/2020,231,2228,0,0,231,2228,FALSE
London,05/04/2020,195,2423,0,0,195,2423,FALSE
London,06/04/2020,198,2621,0,0,198,2621,FALSE
London,07/04/2020,220,2841,0,0,220,2841,FALSE
London,08/04/2020,239,3080,0,0,239,3080,FALSE
London,09/04/2020,207,3287,0,0,207,3287,FALSE
London,10/04/2020,171,3458,0,0,171,3458,FALSE
London,11/04/2020,179,3637,0,0,179,3637,FALSE
London,12/04/2020,159,3796,0,0,159,3796,FALSE
London,13/04/2020,166,3962,0,0,166,3962,FALSE
London,14/04/2020,143,4105,0,0,143,4105,FALSE
London,15/04/2020,143,4248,2,2,145,4250,FALSE
London,16/04/2020,140,4388,0,2,140,4390,FALSE
London,17/04/2020,101,4489,0,2,101,4491,FALSE
London,18/04/2020,101,4590,0,2,101,4592,FALSE
London,19/04/2020,104,4694,0,2,104,4696,FALSE
London,20/04/2020,96,4790,0,2,96,4792,FALSE
London,21/04/2020,96,4886,0,2,96,4888,FALSE
London,22/04/2020,109,4995,0,2,109,4997,FALSE
London,23/04/2020,77,5072,0,2,77,5074,FALSE
London,24/04/2020,71,5143,8,10,79,5153,FALSE
London,25/04/2020,58,5201,9,19,67,5220,FALSE
London,26/04/2020,53,5254,8,27,61,5281,FALSE
London,27/04/2020,52,5306,7,34,59,5340,FALSE
London,28/04/2020,44,5350,6,40,50,5390,FALSE
London,29/04/2020,45,5395,11,51,56,5446,FALSE
London,30/04/2020,40,5435,9,60,49,5495,FALSE
London,01/05/2020,41,5476,6,66,47,5542,FALSE
London,02/05/2020,41,5517,8,74,49,5591,FALSE
London,03/05/2020,36,5553,10,84,46,5637,FALSE
London,04/05/2020,30,5583,7,91,37,5674,FALSE
London,05/05/2020,25,5608,7,98,32,5706,FALSE
London,06/05/2020,37,5645,9,107,46,5752,FALSE
London,07/05/2020,37,5682,6,113,43,5795,FALSE
London,08/05/2020,31,5713,4,117,35,5830,FALSE
London,09/05/2020,23,5736,2,119,25,5855,FALSE
London,10/05/2020,26,5762,4,123,30,5885,FALSE
London,11/05/2020,18,5780,10,133,28,5913,FALSE
London,12/05/2020,18,5798,5,138,23,5936,FALSE
London,13/05/2020,17,5815,1,139,18,5954,FALSE
London,14/05/2020,20,5835,2,141,22,5976,FALSE
London,15/05/2020,19,5854,7,148,26,6002,FALSE
London,16/05/2020,14,5868,3,151,17,6019,FALSE
London,17/05/2020,16,5884,3,154,19,6038,FALSE
London,18/05/2020,11,5895,3,157,14,6052,FALSE
London,19/05/2020,14,5909,2,159,16,6068,FALSE
London,20/05/2020,19,5928,5,164,24,6092,FALSE
London,21/05/2020,12,5940,1,165,13,6105,FALSE
London,22/05/2020,10,5950,2,167,12,6117,FALSE
London,23/05/2020,6,5956,3,170,9,6126,FALSE
London,24/05/2020,7,5963,4,174,11,6137,FALSE
London,25/05/2020,9,5972,1,175,10,6147,FALSE
London,26/05/2020,14,5986,5,180,19,6166,FALSE
London,27/05/2020,7,5993,2,182,9,6175,FALSE
London,28/05/2020,8,6001,2,184,10,6185,FALSE
London,29/05/2020,7,6008,1,185,8,6193,FALSE
London,30/05/2020,12,6020,1,186,13,6206,FALSE
London,31/05/2020,6,6026,3,189,9,6215,FALSE
London,01/06/2020,10,6036,2,191,12,6227,FALSE
London,02/06/2020,8,6044,1,192,9,6236,FALSE
London,03/06/2020,6,6050,0,192,6,6242,FALSE
London,04/06/2020,8,6058,1,193,9,6251,FALSE
London,05/06/2020,4,6062,1,194,5,6256,FALSE
London,06/06/2020,0,6062,3,197,3,6259,FALSE
London,07/06/2020,5,6067,2,199,7,6266,FALSE
London,08/06/2020,5,6072,0,199,5,6271,FALSE
London,09/06/2020,5,6077,1,200,6,6277,FALSE
London,10/06/2020,8,6085,1,201,9,6286,FALSE
London,11/06/2020,5,6090,0,201,5,6291,FALSE
London,12/06/2020,3,6093,2,203,5,6296,FALSE
London,13/06/2020,3,6096,2,205,5,6301,FALSE
London,14/06/2020,3,6099,1,206,4,6305,FALSE
London,15/06/2020,1,6100,0,206,1,6306,FALSE
London,16/06/2020,2,6102,0,206,2,6308,FALSE
London,17/06/2020,1,6103,2,208,3,6311,FALSE
London,18/06/2020,2,6105,0,208,2,6313,FALSE
London,19/06/2020,5,6110,1,209,6,6319,FALSE
London,20/06/2020,3,6113,1,210,4,6323,FALSE
London,21/06/2020,4,6117,0,210,4,6327,FALSE
London,22/06/2020,2,6119,0,210,2,6329,FALSE
London,23/06/2020,1,6120,1,211,2,6331,FALSE
London,24/06/2020,4,6124,0,211,4,6335,FALSE
London,25/06/2020,3,6127,2,213,5,6340,FALSE
London,26/06/2020,2,6129,1,214,3,6343,FALSE
London,27/06/2020,1,6130,0,214,1,6344,FALSE
London,28/06/2020,2,6132,1,215,3,6347,FALSE
London,29/06/2020,2,6134,1,216,3,6350,FALSE
London,30/06/2020,1,6135,2,218,3,6353,FALSE
London,01/07/2020,3,6138,1,219,4,6357,FALSE
London,02/07/2020,2,6140,2,221,4,6361,FALSE
London,03/07/2020,2,6142,1,222,3,6364,FALSE
London,04/07/2020,1,6143,1,223,2,6366,FALSE
London,05/07/2020,3,6146,1,224,4,6370,FALSE
London,06/07/2020,2,6148,0,224,2,6372,FALSE
London,07/07/2020,1,6149,0,224,1,6373,FALSE
London,08/07/2020,3,6152,0,224,3,6376,FALSE
London,09/07/2020,4,6156,0,224,4,6380,FALSE
London,10/07/2020,0,6156,1,225,1,6381,FALSE
London,11/07/2020,1,6157,0,225,1,6382,FALSE
London,12/07/2020,1,6158,0,225,1,6383,FALSE
London,13/07/2020,1,6159,0,225,1,6384,FALSE
London,14/07/2020,0,6159,0,225,0,6384,FALSE
London,15/07/2020,2,6161,0,225,2,6386,FALSE
London,16/07/2020,0,6161,0,225,0,6386,FALSE
London,17/07/2020,0,6161,0,225,0,6386,FALSE
London,18/07/2020,2,6163,0,225,2,6388,FALSE
London,19/07/2020,0,6163,1,226,1,6389,FALSE
London,20/07/2020,0,6163,1,227,1,6390,FALSE
London,21/07/2020,1,6164,2,229,3,6393,FALSE
London,22/07/2020,0,6164,2,231,2,6395,FALSE
London,23/07/2020,2,6166,2,233,4,6399,FALSE
London,24/07/2020,0,6166,1,234,1,6400,FALSE
London,25/07/2020,1,6167,0,234,1,6401,FALSE
London,26/07/2020,0,6167,0,234,0,6401,FALSE
London,27/07/2020,1,6168,0,234,1,6402,FALSE
London,28/07/2020,0,6168,2,236,2,6404,FALSE
London,29/07/2020,0,6168,0,236,0,6404,FALSE
London,30/07/2020,1,6169,0,236,1,6405,FALSE
London,31/07/2020,0,6169,0,236,0,6405,FALSE
London,01/08/2020,0,6169,0,236,0,6405,FALSE
London,02/08/2020,3,6172,1,237,4,6409,FALSE
London,03/08/2020,0,6172,0,237,0,6409,FALSE
London,04/08/2020,0,6172,1,238,1,6410,FALSE
London,05/08/2020,0,6172,0,238,0,6410,FALSE
London,06/08/2020,1,6173,1,239,2,6412,FALSE
London,07/08/2020,0,6173,0,239,0,6412,FALSE
London,08/08/2020,0,6173,0,239,0,6412,FALSE
London,09/08/2020,0,6173,0,239,0,6412,FALSE
London,10/08/2020,0,6173,1,240,1,6413,FALSE
London,11/08/2020,1,6174,1,241,2,6415,FALSE
London,12/08/2020,0,6174,0,241,0,6415,FALSE
London,13/08/2020,2,6176,0,241,2,6417,FALSE
London,14/08/2020,0,6176,1,242,1,6418,FALSE
London,15/08/2020,0,6176,0,242,0,6418,FALSE
London,16/08/2020,0,6176,0,242,0,6418,FALSE
London,17/08/2020,1,6177,0,242,1,6419,FALSE
London,18/08/2020,1,6178,0,242,1,6420,FALSE
London,19/08/2020,0,6178,0,242,0,6420,FALSE
London,20/08/2020,1,6179,1,243,2,6422,FALSE
London,21/08/2020,0,6179,0,243,0,6422,FALSE
London,22/08/2020,0,6179,0,243,0,6422,FALSE
London,23/08/2020,0,6179,1,244,1,6423,FALSE
London,24/08/2020,1,6180,1,245,2,6425,FALSE
London,25/08/2020,1,6181,0,245,1,6426,FALSE
London,26/08/2020,0,6181,0,245,0,6426,FALSE
London,27/08/2020,0,6181,1,246,1,6427,FALSE
London,28/08/2020,0,6181,0,246,0,6427,FALSE
London,29/08/2020,0,6181,0,246,0,6427,FALSE
London,30/08/2020,0,6181,0,246,0,6427,FALSE
London,31/08/2020,1,6182,0,246,1,6428,FALSE
London,01/09/2020,0,6182,0,246,0,6428,FALSE
London,02/09/2020,1,6183,0,246,1,6429,FALSE
London,03/09/2020,1,6184,0,246,1,6430,FALSE
London,04/09/2020,0,6184,0,246,0,6430,FALSE
London,05/09/2020,0,6184,0,246,0,6430,FALSE
London,06/09/2020,2,6186,0,246,2,6432,FALSE
London,07/09/2020,0,6186,0,246,0,6432,FALSE
London,08/09/2020,0,6186,1,247,1,6433,FALSE
London,09/09/2020,0,6186,0,247,0,6433,FALSE
London,10/09/2020,2,6188,2,249,4,6437,FALSE
London,11/09/2020,2,6190,1,250,3,6440,FALSE
London,12/09/2020,1,6191,0,250,1,6441,FALSE
London,13/09/2020,0,6191,0,250,0,6441,FALSE
London,14/09/2020,0,6191,0,250,0,6441,FALSE
London,15/09/2020,1,6192,2,252,3,6444,FALSE
London,16/09/2020,2,6194,0,252,2,6446,FALSE
London,17/09/2020,2,6196,1,253,3,6449,FALSE
London,18/09/2020,1,6197,1,254,2,6451,FALSE
London,19/09/2020,3,6200,3,257,6,6457,FALSE
London,20/09/2020,3,6203,0,257,3,6460,FALSE
London,21/09/2020,2,6205,0,257,2,6462,FALSE
London,22/09/2020,6,6211,0,257,6,6468,FALSE
London,23/09/2020,4,6215,1,258,5,6473,FALSE
London,24/09/2020,3,6218,0,258,3,6476,FALSE
London,25/09/2020,1,6219,0,258,1,6477,FALSE
London,26/09/2020,1,6220,1,259,2,6479,FALSE
London,27/09/2020,1,6221,0,259,1,6480,FALSE
London,28/09/2020,3,6224,1,260,4,6484,FALSE
London,29/09/2020,7,6231,0,260,7,6491,FALSE
London,30/09/2020,6,6237,1,261,7,6498,FALSE
London,01/10/2020,4,6241,1,262,5,6503,FALSE
London,02/10/2020,1,6242,0,262,1,6504,FALSE
London,03/10/2020,3,6245,1,263,4,6508,FALSE
London,04/10/2020,2,6247,0,263,2,6510,FALSE
London,05/10/2020,7,6254,0,263,7,6517,FALSE
London,06/10/2020,4,6258,1,264,5,6522,FALSE
London,07/10/2020,6,6264,1,265,7,6529,FALSE
London,08/10/2020,6,6270,1,266,7,6536,FALSE
London,09/10/2020,7,6277,1,267,8,6544,FALSE
London,10/10/2020,3,6280,0,267,3,6547,FALSE
London,11/10/2020,5,6285,0,267,5,6552,FALSE
London,12/10/2020,7,6292,0,267,7,6559,FALSE
London,13/10/2020,4,6296,2,269,6,6565,FALSE
London,14/10/2020,6,6302,0,269,6,6571,FALSE
London,15/10/2020,13,6315,4,273,17,6588,FALSE
London,16/10/2020,6,6321,1,274,7,6595,FALSE
London,17/10/2020,2,6323,0,274,2,6597,FALSE
London,18/10/2020,5,6328,0,274,5,6602,FALSE
London,19/10/2020,11,6339,1,275,12,6614,FALSE
London,20/10/2020,8,6347,0,275,8,6622,FALSE
London,21/10/2020,14,6361,0,275,14,6636,FALSE
London,22/10/2020,12,6373,0,275,12,6648,FALSE
London,23/10/2020,7,6380,0,275,7,6655,FALSE
London,24/10/2020,18,6398,0,275,18,6673,FALSE
London,25/10/2020,10,6408,2,277,12,6685,FALSE
London,26/10/2020,10,6418,1,278,11,6696,FALSE
London,27/10/2020,12,6430,1,279,13,6709,FALSE
London,28/10/2020,23,6453,0,279,23,6732,FALSE
London,29/10/2020,14,6467,1,280,15,6747,FALSE
London,30/10/2020,17,6484,0,280,17,6764,FALSE
London,31/10/2020,7,6491,0,280,7,6771,FALSE
London,01/11/2020,17,6508,2,282,19,6790,FALSE
London,02/11/2020,16,6524,3,285,19,6809,FALSE
London,03/11/2020,10,6534,3,288,13,6822,FALSE
London,04/11/2020,18,6552,0,288,18,6840,FALSE
London,05/11/2020,17,6569,1,289,18,6858,FALSE
London,06/11/2020,12,6581,1,290,13,6871,FALSE
London,07/11/2020,21,6602,0,290,21,6892,FALSE
London,08/11/2020,15,6617,0,290,15,6907,FALSE
London,09/11/2020,28,6645,0,290,28,6935,FALSE
London,10/11/2020,14,6659,2,292,16,6951,FALSE
London,11/11/2020,15,6674,1,293,16,6967,FALSE
London,12/11/2020,16,6690,0,293,16,6983,FALSE
London,13/11/2020,14,6704,1,294,15,6998,FALSE
London,14/11/2020,21,6725,1,295,22,7020,FALSE
London,15/11/2020,18,6743,0,295,18,7038,FALSE
London,16/11/2020,29,6772,4,299,33,7071,FALSE
London,17/11/2020,29,6801,3,302,32,7103,FALSE
London,18/11/2020,23,6824,1,303,24,7127,FALSE
London,19/11/2020,24,6848,2,305,26,7153,FALSE
London,20/11/2020,20,6868,1,306,21,7174,FALSE
London,21/11/2020,19,6887,3,309,22,7196,FALSE
London,22/11/2020,29,6916,1,310,30,7226,FALSE
London,23/11/2020,19,6935,6,316,25,7251,FALSE
London,24/11/2020,27,6962,3,319,30,7281,FALSE
London,25/11/2020,30,6992,2,321,32,7313,FALSE
London,26/11/2020,25,7017,2,323,27,7340,FALSE
London,27/11/2020,28,7045,3,326,31,7371,FALSE
London,28/11/2020,23,7068,0,326,23,7394,FALSE
London,29/11/2020,40,7108,3,329,43,7437,FALSE
London,30/11/2020,19,7127,3,332,22,7459,FALSE
London,01/12/2020,28,7155,3,335,31,7490,FALSE
London,02/12/2020,30,7185,2,337,32,7522,FALSE
London,03/12/2020,27,7212,2,339,29,7551,FALSE
London,04/12/2020,30,7242,4,343,34,7585,FALSE
London,05/12/2020,26,7268,3,346,29,7614,FALSE
London,06/12/2020,25,7293,1,347,26,7640,FALSE
London,07/12/2020,30,7323,5,352,35,7675,FALSE
London,08/12/2020,35,7358,1,353,36,7711,FALSE
London,09/12/2020,28,7386,1,354,29,7740,FALSE
London,10/12/2020,31,7417,2,356,33,7773,FALSE
London,11/12/2020,27,7444,2,358,29,7802,FALSE
London,12/12/2020,33,7477,4,362,37,7839,FALSE
London,13/12/2020,34,7511,1,363,35,7874,FALSE
London,14/12/2020,39,7550,3,366,42,7916,FALSE
London,15/12/2020,49,7599,3,369,52,7968,FALSE
London,16/12/2020,38,7637,2,371,40,8008,FALSE
London,17/12/2020,58,7695,2,373,60,8068,FALSE
London,18/12/2020,43,7738,6,379,49,8117,FALSE
London,19/12/2020,42,7780,5,384,47,8164,FALSE
London,20/12/2020,55,7835,5,389,60,8224,FALSE
London,21/12/2020,60,7895,2,391,62,8286,FALSE
London,22/12/2020,59,7954,18,409,77,8363,FALSE
London,23/12/2020,58,8012,8,417,66,8429,FALSE
London,24/12/2020,65,8077,1,418,66,8495,FALSE
London,25/12/2020,82,8159,9,427,91,8586,FALSE
London,26/12/2020,82,8241,4,431,86,8672,FALSE
London,27/12/2020,92,8333,7,438,99,8771,FALSE
London,28/12/2020,89,8422,9,447,98,8869,FALSE
London,29/12/2020,110,8532,5,452,115,8984,FALSE
London,30/12/2020,102,8634,10,462,112,9096,FALSE
London,31/12/2020,110,8744,10,472,120,9216,FALSE
London,01/01/2021,114,8858,9,481,123,9339,FALSE
London,02/01/2021,126,8984,17,498,143,9482,FALSE
London,03/01/2021,107,9091,12,510,119,9601,FALSE
London,04/01/2021,151,9242,11,521,162,9763,FALSE
London,05/01/2021,149,9391,5,526,154,9917,FALSE
London,06/01/2021,148,9539,13,539,161,10078,FALSE
London,07/01/2021,159,9698,11,550,170,10248,FALSE
London,08/01/2021,140,9838,8,558,148,10396,FALSE
London,09/01/2021,148,9986,7,565,155,10551,FALSE
London,10/01/2021,162,10148,9,574,171,10722,FALSE
London,11/01/2021,163,10311,11,585,174,10896,FALSE
London,12/01/2021,172,10483,9,594,181,11077,FALSE
London,13/01/2021,169,10652,11,605,180,11257,FALSE
London,14/01/2021,159,10811,15,620,174,11431,FALSE
London,15/01/2021,149,10960,10,630,159,11590,FALSE
London,16/01/2021,161,11121,12,642,173,11763,FALSE
London,17/01/2021,170,11291,11,653,181,11944,FALSE
London,18/01/2021,187,11478,9,662,196,12140,FALSE
London,19/01/2021,182,11660,12,674,194,12334,FALSE
London,20/01/2021,161,11821,7,681,168,12502,FALSE
London,21/01/2021,182,12003,11,692,193,12695,FALSE
London,22/01/2021,143,12146,12,704,155,12850,FALSE
London,23/01/2021,141,12287,10,714,151,13001,FALSE
London,24/01/2021,130,12417,13,727,143,13144,FALSE
London,25/01/2021,128,12545,16,743,144,13288,FALSE
London,26/01/2021,120,12665,14,757,134,13422,FALSE
London,27/01/2021,116,12781,14,771,130,13552,FALSE
London,28/01/2021,110,12891,13,784,123,13675,FALSE
London,29/01/2021,97,12988,10,794,107,13782,FALSE
London,30/01/2021,88,13076,4,798,92,13874,FALSE
London,31/01/2021,91,13167,7,805,98,13972,FALSE
London,01/02/2021,80,13247,13,818,93,14065,FALSE
London,02/02/2021,100,13347,9,827,109,14174,FALSE
London,03/02/2021,108,13455,7,834,115,14289,FALSE
London,04/02/2021,64,13519,8,842,72,14361,FALSE
London,05/02/2021,86,13605,8,850,94,14455,FALSE
London,06/02/2021,62,13667,11,861,73,14528,FALSE
London,07/02/2021,71,13738,11,872,82,14610,FALSE
London,08/02/2021,66,13804,9,881,75,14685,FALSE
London,09/02/2021,60,13864,9,890,69,14754,FALSE
London,10/02/2021,72,13936,5,895,77,14831,FALSE
London,11/02/2021,50,13986,5,900,55,14886,FALSE
London,12/02/2021,53,14039,6,906,59,14945,FALSE
London,13/02/2021,45,14084,12,918,57,15002,FALSE
London,14/02/2021,43,14127,9,927,52,15054,FALSE
London,15/02/2021,38,14165,10,937,48,15102,FALSE
London,16/02/2021,51,14216,8,945,59,15161,FALSE
London,17/02/2021,44,14260,6,951,50,15211,FALSE
London,18/02/2021,44,14304,10,961,54,15265,FALSE
London,19/02/2021,42,14346,8,969,50,15315,FALSE
London,20/02/2021,28,14374,5,974,33,15348,FALSE
London,21/02/2021,37,14411,10,984,47,15395,FALSE
London,22/02/2021,31,14442,8,992,39,15434,FALSE
London,23/02/2021,23,14465,8,1000,31,15465,FALSE
London,24/02/2021,26,14491,7,1007,33,15498,FALSE
London,25/02/2021,21,14512,11,1018,32,15530,FALSE
London,26/02/2021,24,14536,8,1026,32,15562,FALSE
London,27/02/2021,18,14554,4,1030,22,15584,FALSE
London,28/02/2021,13,14567,5,1035,18,15602,FALSE
London,01/03/2021,26,14593,5,1040,31,15633,FALSE
London,02/03/2021,21,14614,5,1045,26,15659,FALSE
London,03/03/2021,8,14622,9,1054,17,15676,FALSE
London,04/03/2021,13,14635,5,1059,18,15694,FALSE
London,05/03/2021,18,14653,6,1065,24,15718,FALSE
London,06/03/2021,17,14670,6,1071,23,15741,FALSE
London,07/03/2021,12,14682,4,1075,16,15757,FALSE
London,08/03/2021,10,14692,6,1081,16,15773,FALSE
London,09/03/2021,10,14702,7,1088,17,15790,FALSE
London,10/03/2021,13,14715,1,1089,14,15804,FALSE
London,11/03/2021,12,14727,4,1093,16,15820,FALSE
London,12/03/2021,7,14734,2,1095,9,15829,FALSE
London,13/03/2021,9,14743,5,1100,14,15843,FALSE
London,14/03/2021,4,14747,3,1103,7,15850,FALSE
London,15/03/2021,7,14754,5,1108,12,15862,FALSE
London,16/03/2021,4,14758,4,1112,8,15870,FALSE
London,17/03/2021,10,14768,5,1117,15,15885,FALSE
London,18/03/2021,9,14777,1,1118,10,15895,FALSE
London,19/03/2021,5,14782,1,1119,6,15901,FALSE
London,20/03/2021,4,14786,2,1121,6,15907,FALSE
London,21/03/2021,5,14791,6,1127,11,15918,FALSE
London,22/03/2021,7,14798,3,1130,10,15928,FALSE
London,23/03/2021,2,14800,3,1133,5,15933,FALSE
London,24/03/2021,6,14806,4,1137,10,15943,FALSE
London,25/03/2021,2,14808,2,1139,4,15947,FALSE
London,26/03/2021,2,14810,1,1140,3,15950,FALSE
London,27/03/2021,4,14814,2,1142,6,15956,FALSE
London,28/03/2021,3,14817,2,1144,5,15961,FALSE
London,29/03/2021,1,14818,1,1145,2,15963,FALSE
London,30/03/2021,4,14822,1,1146,5,15968,FALSE
London,31/03/2021,5,14827,0,1146,5,15973,FALSE
London,01/04/2021,4,14831,2,1148,6,15979,FALSE
London,02/04/2021,4,14835,1,1149,5,15984,FALSE
London,03/04/2021,4,14839,3,1152,7,15991,FALSE
London,04/04/2021,0,14839,3,1155,3,15994,FALSE
London,05/04/2021,2,14841,3,1158,5,15999,FALSE
London,06/04/2021,1,14842,1,1159,2,16001,FALSE
London,07/04/2021,3,14845,0,1159,3,16004,FALSE
London,08/04/2021,4,14849,5,1164,9,16013,FALSE
London,09/04/2021,1,14850,3,1167,4,16017,FALSE
London,10/04/2021,4,14854,6,1173,10,16027,FALSE
London,11/04/2021,5,14859,0,1173,5,16032,FALSE
London,12/04/2021,0,14859,1,1174,1,16033,FALSE
London,13/04/2021,4,14863,2,1176,6,16039,FALSE
London,14/04/2021,1,14864,2,1178,3,16042,FALSE
London,15/04/2021,1,14865,2,1180,3,16045,FALSE
London,16/04/2021,4,14869,1,1181,5,16050,FALSE
London,17/04/2021,1,14870,2,1183,3,16053,FALSE
London,18/04/2021,2,14872,1,1184,3,16056,FALSE
London,19/04/2021,5,14877,1,1185,6,16062,FALSE
London,20/04/2021,2,14879,0,1185,2,16064,FALSE
London,21/04/2021,2,14881,0,1185,2,16066,FALSE
London,22/04/2021,1,14882,0,1185,1,16067,FALSE
London,23/04/2021,1,14883,0,1185,1,16068,FALSE
London,24/04/2021,2,14885,1,1186,3,16071,FALSE
London,25/04/2021,1,14886,1,1187,2,16073,FALSE
London,26/04/2021,0,14886,0,1187,0,16073,FALSE
London,27/04/2021,3,14889,1,1188,4,16077,FALSE
London,28/04/2021,3,14892,1,1189,4,16081,FALSE
London,29/04/2021,0,14892,1,1190,1,16082,FALSE
London,30/04/2021,2,14894,1,1191,3,16085,FALSE
London,01/05/2021,4,14898,1,1192,5,16090,FALSE
London,02/05/2021,1,14899,2,1194,3,16093,FALSE
London,03/05/2021,2,14901,1,1195,3,16096,FALSE
London,04/05/2021,2,14903,0,1195,2,16098,FALSE
London,05/05/2021,3,14906,2,1197,5,16103,FALSE
London,06/05/2021,0,14906,0,1197,0,16103,FALSE
London,07/05/2021,1,14907,0,1197,1,16104,FALSE
London,08/05/2021,0,14907,0,1197,0,16104,FALSE
London,09/05/2021,1,14908,0,1197,1,16105,FALSE
London,10/05/2021,1,14909,1,1198,2,16107,FALSE
London,11/05/2021,0,14909,0,1198,0,16107,FALSE
London,12/05/2021,0,14909,1,1199,1,16108,FALSE
London,13/05/2021,0,14909,1,1200,1,16109,FALSE
London,14/05/2021,1,14910,0,1200,1,16110,FALSE
London,15/05/2021,0,14910,1,1201,1,16111,FALSE
London,16/05/2021,2,14912,0,1201,2,16113,FALSE
London,17/05/2021,1,14913,1,1202,2,16115,FALSE
London,18/05/2021,1,14914,0,1202,1,16116,FALSE
London,19/05/2021,0,14914,0,1202,0,16116,FALSE
London,20/05/2021,1,14915,1,1203,2,16118,FALSE
London,21/05/2021,0,14915,2,1205,2,16120,FALSE
London,22/05/2021,0,14915,1,1206,1,16121,FALSE
London,23/05/2021,2,14917,1,1207,3,16124,FALSE
London,24/05/2021,1,14918,1,1208,2,16126,FALSE
London,25/05/2021,1,14919,0,1208,1,16127,FALSE
London,26/05/2021,5,14924,0,1208,5,16132,FALSE
London,27/05/2021,3,14927,0,1208,3,16135,FALSE
London,28/05/2021,0,14927,0,1208,0,16135,FALSE
London,29/05/2021,2,14929,1,1209,3,16138,FALSE
London,30/05/2021,2,14931,1,1210,3,16141,FALSE
London,31/05/2021,1,14932,1,1211,2,16143,FALSE
London,01/06/2021,0,14932,0,1211,0,16143,FALSE
London,02/06/2021,2,14934,0,1211,2,16145,FALSE
London,03/06/2021,1,14935,1,1212,2,16147,FALSE
London,04/06/2021,2,14937,0,1212,2,16149,FALSE
London,05/06/2021,0,14937,1,1213,1,16150,FALSE
London,06/06/2021,3,14940,1,1214,4,16154,FALSE
London,07/06/2021,0,14940,2,1216,2,16156,FALSE
London,08/06/2021,1,14941,1,1217,2,16158,FALSE
London,09/06/2021,2,14943,1,1218,3,16161,FALSE
London,10/06/2021,0,14943,0,1218,0,16161,FALSE
London,11/06/2021,0,14943,0,1218,0,16161,FALSE
London,12/06/2021,1,14944,1,1219,2,16163,FALSE
London,13/06/2021,2,14946,0,1219,2,16165,FALSE
London,14/06/2021,0,14946,0,1219,0,16165,FALSE
London,15/06/2021,1,14947,0,1219,1,16166,FALSE
London,16/06/2021,0,14947,1,1220,1,16167,FALSE
London,17/06/2021,2,14949,1,1221,3,16170,FALSE
London,18/06/2021,5,14954,1,1222,6,16176,FALSE
London,19/06/2021,1,14955,0,1222,1,16177,FALSE
London,20/06/2021,1,14956,0,1222,1,16178,FALSE
London,21/06/2021,1,14957,0,1222,1,16179,FALSE
London,22/06/2021,0,14957,1,1223,1,16180,FALSE
London,23/06/2021,0,14957,0,1223,0,16180,FALSE
London,24/06/2021,2,14959,0,1223,2,16182,FALSE
London,25/06/2021,4,14963,0,1223,4,16186,FALSE
London,26/06/2021,1,14964,0,1223,1,16187,FALSE
London,27/06/2021,2,14966,0,1223,2,16189,FALSE
London,28/06/2021,1,14967,0,1223,1,16190,FALSE
London,29/06/2021,2,14969,1,1224,3,16193,FALSE
London,30/06/2021,2,14971,3,1227,5,16198,FALSE
London,01/07/2021,2,14973,0,1227,2,16200,FALSE
London,02/07/2021,3,14976,0,1227,3,16203,FALSE
London,03/07/2021,3,14979,1,1228,4,16207,FALSE
London,04/07/2021,1,14980,0,1228,1,16208,FALSE
London,05/07/2021,1,14981,1,1229,2,16210,FALSE
London,06/07/2021,1,14982,0,1229,1,16211,FALSE
London,07/07/2021,2,14984,1,1230,3,16214,FALSE
London,08/07/2021,2,14986,0,1230,2,16216,FALSE
London,09/07/2021,1,14987,0,1230,1,16217,FALSE
London,10/07/2021,3,14990,0,1230,3,16220,FALSE
London,11/07/2021,0,14990,0,1230,0,16220,FALSE
London,12/07/2021,1,14991,1,1231,2,16222,FALSE
London,13/07/2021,3,14994,0,1231,3,16225,FALSE
London,14/07/2021,3,14997,1,1232,4,16229,FALSE
London,15/07/2021,2,14999,1,1233,3,16232,FALSE
London,16/07/2021,3,15002,1,1234,4,16236,FALSE
London,17/07/2021,7,15009,1,1235,8,16244,FALSE
London,18/07/2021,5,15014,1,1236,6,16250,FALSE
London,19/07/2021,7,15021,1,1237,8,16258,FALSE
London,20/07/2021,7,15028,1,1238,8,16266,FALSE
London,21/07/2021,6,15034,1,1239,7,16273,FALSE
London,22/07/2021,4,15038,0,1239,4,16277,FALSE
London,23/07/2021,8,15046,0,1239,8,16285,FALSE
London,24/07/2021,7,15053,0,1239,7,16292,FALSE
London,25/07/2021,5,15058,0,1239,5,16297,FALSE
London,26/07/2021,9,15067,0,1239,9,16306,FALSE
London,27/07/2021,3,15070,0,1239,3,16309,FALSE
London,28/07/2021,10,15080,0,1239,10,16319,FALSE
London,29/07/2021,10,15090,0,1239,10,16329,FALSE
London,30/07/2021,11,15101,0,1239,11,16340,FALSE
London,31/07/2021,7,15108,0,1239,7,16347,FALSE
London,01/08/2021,8,15116,0,1239,8,16355,FALSE
London,02/08/2021,10,15126,0,1239,10,16365,FALSE
London,03/08/2021,5,15131,2,1241,7,16372,FALSE
London,04/08/2021,15,15146,1,1242,16,16388,FALSE
London,05/08/2021,14,15160,0,1242,14,16402,FALSE
London,06/08/2021,11,15171,0,1242,11,16413,FALSE
London,07/08/2021,9,15180,0,1242,9,16422,FALSE
London,08/08/2021,6,15186,3,1245,9,16431,FALSE
London,09/08/2021,4,15190,0,1245,4,16435,FALSE
London,10/08/2021,7,15197,1,1246,8,16443,FALSE
London,11/08/2021,14,15211,1,1247,15,16458,FALSE
London,12/08/2021,15,15226,0,1247,15,16473,FALSE
London,13/08/2021,9,15235,0,1247,9,16482,FALSE
London,14/08/2021,12,15247,1,1248,13,16495,FALSE
London,15/08/2021,14,15261,1,1249,15,16510,FALSE
London,16/08/2021,10,15271,0,1249,10,16520,FALSE
London,17/08/2021,10,15281,0,1249,10,16530,FALSE
London,18/08/2021,9,15290,1,1250,10,16540,FALSE
London,19/08/2021,10,15300,3,1253,13,16553,FALSE
London,20/08/2021,18,15318,1,1254,19,16572,FALSE
London,21/08/2021,13,15331,2,1256,15,16587,FALSE
London,22/08/2021,13,15344,1,1257,14,16601,FALSE
London,23/08/2021,11,15355,0,1257,11,16612,FALSE
London,24/08/2021,8,15363,1,1258,9,16621,FALSE
London,25/08/2021,8,15371,2,1260,10,16631,FALSE
London,26/08/2021,16,15387,1,1261,17,16648,FALSE
London,27/08/2021,11,15398,0,1261,11,16659,FALSE
London,28/08/2021,13,15411,0,1261,13,16672,FALSE
London,29/08/2021,8,15419,2,1263,10,16682,FALSE
London,30/08/2021,9,15428,1,1264,10,16692,FALSE
London,31/08/2021,14,15442,0,1264,14,16706,FALSE
London,01/09/2021,10,15452,1,1265,11,16717,FALSE
London,02/09/2021,12,15464,0,1265,12,16729,FALSE
London,03/09/2021,23,15487,0,1265,23,16752,FALSE
London,04/09/2021,8,15495,0,1265,8,16760,FALSE
London,05/09/2021,8,15503,4,1269,12,16772,FALSE
London,06/09/2021,14,15517,5,1274,19,16791,FALSE
London,07/09/2021,14,15531,0,1274,14,16805,FALSE
London,08/09/2021,9,15540,1,1275,10,16815,FALSE
London,09/09/2021,18,15558,0,1275,18,16833,FALSE
London,10/09/2021,9,15567,0,1275,9,16842,FALSE
London,11/09/2021,7,15574,1,1276,8,16850,FALSE
London,12/09/2021,6,15580,0,1276,6,16856,FALSE
London,13/09/2021,5,15585,1,1277,6,16862,FALSE
London,14/09/2021,13,15598,1,1278,14,16876,FALSE
London,15/09/2021,11,15609,2,1280,13,16889,FALSE
London,16/09/2021,12,15621,1,1281,13,16902,FALSE
London,17/09/2021,11,15632,0,1281,11,16913,FALSE
London,18/09/2021,9,15641,0,1281,9,16922,FALSE
London,19/09/2021,6,15647,0,1281,6,16928,FALSE
London,20/09/2021,12,15659,0,1281,12,16940,FALSE
London,21/09/2021,6,15665,2,1283,8,16948,FALSE
London,22/09/2021,15,15680,2,1285,17,16965,FALSE
London,23/09/2021,14,15694,2,1287,16,16981,FALSE
London,24/09/2021,16,15710,2,1289,18,16999,FALSE
London,25/09/2021,11,15721,0,1289,11,17010,FALSE
London,26/09/2021,6,15727,3,1292,9,17019,FALSE
London,27/09/2021,13,15740,1,1293,14,17033,FALSE
London,28/09/2021,11,15751,2,1295,13,17046,FALSE
London,29/09/2021,15,15766,1,1296,16,17062,FALSE
London,30/09/2021,10,15776,5,1301,15,17077,FALSE
London,01/10/2021,14,15790,3,1304,17,17094,FALSE
London,02/10/2021,12,15802,2,1306,14,17108,FALSE
London,03/10/2021,5,15807,1,1307,6,17114,FALSE
London,04/10/2021,12,15819,0,1307,12,17126,FALSE
London,05/10/2021,12,15831,3,1310,15,17141,FALSE
London,06/10/2021,9,15840,2,1312,11,17152,FALSE
London,07/10/2021,9,15849,0,1312,9,17161,FALSE
London,08/10/2021,9,15858,1,1313,10,17171,FALSE
London,09/10/2021,12,15870,3,1316,15,17186,FALSE
London,10/10/2021,8,15878,2,1318,10,17196,FALSE
London,11/10/2021,9,15887,2,1320,11,17207,FALSE
London,12/10/2021,7,15894,2,1322,9,17216,FALSE
London,13/10/2021,6,15900,1,1323,7,17223,FALSE
London,14/10/2021,12,15912,3,1326,15,17238,FALSE
London,15/10/2021,6,15918,1,1327,7,17245,FALSE
London,16/10/2021,7,15925,1,1328,8,17253,FALSE
London,17/10/2021,12,15937,2,1330,14,17267,FALSE
London,18/10/2021,10,15947,2,1332,12,17279,FALSE
London,19/10/2021,9,15956,1,1333,10,17289,FALSE
London,20/10/2021,3,15959,0,1333,3,17292,FALSE
London,21/10/2021,10,15969,2,1335,12,17304,FALSE
London,22/10/2021,9,15978,1,1336,10,17314,FALSE
London,23/10/2021,7,15985,1,1337,8,17322,FALSE
London,24/10/2021,10,15995,0,1337,10,17332,FALSE
London,25/10/2021,13,16008,0,1337,13,17345,FALSE
London,26/10/2021,10,16018,0,1337,10,17355,FALSE
London,27/10/2021,15,16033,2,1339,17,17372,FALSE
London,28/10/2021,11,16044,1,1340,12,17384,FALSE
London,29/10/2021,9,16053,0,1340,9,17393,FALSE
London,30/10/2021,10,16063,0,1340,10,17403,FALSE
London,31/10/2021,12,16075,0,1340,12,17415,FALSE
London,01/11/2021,12,16087,1,1341,13,17428,FALSE
London,02/11/2021,12,16099,0,1341,12,17440,FALSE
London,03/11/2021,10,16109,0,1341,10,17450,FALSE
London,04/11/2021,10,16119,0,1341,10,17460,FALSE
London,05/11/2021,9,16128,0,1341,9,17469,FALSE
London,06/11/2021,12,16140,2,1343,14,17483,FALSE
London,07/11/2021,12,16152,3,1346,15,17498,FALSE
London,08/11/2021,14,16166,3,1349,17,17515,FALSE
London,09/11/2021,6,16172,1,1350,7,17522,FALSE
London,10/11/2021,11,16183,3,1353,14,17536,FALSE
London,11/11/2021,12,16195,1,1354,13,17549,FALSE
London,12/11/2021,8,16203,2,1356,10,17559,FALSE
London,13/11/2021,12,16215,2,1358,14,17573,FALSE
London,14/11/2021,10,16225,1,1359,11,17584,FALSE
London,15/11/2021,12,16237,1,1360,13,17597,FALSE
London,16/11/2021,11,16248,0,1360,11,17608,FALSE
London,17/11/2021,4,16252,1,1361,5,17613,FALSE
London,18/11/2021,7,16259,0,1361,7,17620,FALSE
London,19/11/2021,7,16266,0,1361,7,17627,FALSE
London,20/11/2021,7,16273,1,1362,8,17635,FALSE
London,21/11/2021,7,16280,0,1362,7,17642,FALSE
London,22/11/2021,9,16289,2,1364,11,17653,FALSE
London,23/11/2021,10,16299,1,1365,11,17664,FALSE
London,24/11/2021,16,16315,0,1365,16,17680,FALSE
London,25/11/2021,11,16326,0,1365,11,17691,FALSE
London,26/11/2021,10,16336,0,1365,10,17701,FALSE
London,27/11/2021,7,16343,2,1367,9,17710,FALSE
London,28/11/2021,10,16353,2,1369,12,17722,FALSE
London,29/11/2021,10,16363,1,1370,11,17733,FALSE
London,30/11/2021,14,16377,3,1373,17,17750,FALSE
London,01/12/2021,8,16385,0,1373,8,17758,FALSE
London,02/12/2021,8,16393,0,1373,8,17766,FALSE
London,03/12/2021,13,16406,0,1373,13,17779,FALSE
London,04/12/2021,15,16421,2,1375,17,17796,FALSE
London,05/12/2021,14,16435,0,1375,14,17810,FALSE
London,06/12/2021,8,16443,3,1378,11,17821,FALSE
London,07/12/2021,11,16454,0,1378,11,17832,FALSE
London,08/12/2021,9,16463,0,1378,9,17841,FALSE
London,09/12/2021,13,16476,1,1379,14,17855,FALSE
London,10/12/2021,13,16489,0,1379,13,17868,FALSE
London,11/12/2021,11,16500,1,1380,12,17880,FALSE
London,12/12/2021,22,16522,0,1380,22,17902,FALSE
London,13/12/2021,16,16538,4,1384,20,17922,FALSE
London,14/12/2021,16,16554,2,1386,18,17940,FALSE
London,15/12/2021,12,16566,0,1386,12,17952,FALSE
London,16/12/2021,12,16578,0,1386,12,17964,FALSE
London,17/12/2021,9,16587,1,1387,10,17974,FALSE
London,18/12/2021,19,16606,3,1390,22,17996,FALSE
London,19/12/2021,14,16620,1,1391,15,18011,FALSE
London,20/12/2021,7,16627,0,1391,7,18018,FALSE
London,21/12/2021,12,16639,1,1392,13,18031,FALSE
London,22/12/2021,20,16659,1,1393,21,18052,FALSE
London,23/12/2021,19,16678,3,1396,22,18074,FALSE
London,24/12/2021,17,16695,4,1400,21,18095,FALSE
London,25/12/2021,11,16706,1,1401,12,18107,FALSE
London,26/12/2021,19,16725,0,1401,19,18126,FALSE
London,27/12/2021,20,16745,0,1401,20,18146,FALSE
London,28/12/2021,23,16768,1,1402,24,18170,FALSE
London,29/12/2021,23,16791,0,1402,23,18193,FALSE
London,30/12/2021,30,16821,2,1404,32,18225,FALSE
London,31/12/2021,16,16837,2,1406,18,18243,FALSE
London,01/01/2022,34,16871,1,1407,35,18278,FALSE
London,02/01/2022,30,16901,1,1408,31,18309,FALSE
London,03/01/2022,26,16927,6,1414,32,18341,FALSE
London,04/01/2022,23,16950,0,1414,23,18364,FALSE
London,05/01/2022,24,16974,1,1415,25,18389,FALSE
London,06/01/2022,31,17005,4,1419,35,18424,FALSE
London,07/01/2022,31,17036,1,1420,32,18456,FALSE
London,08/01/2022,32,17068,2,1422,34,18490,FALSE
London,09/01/2022,30,17098,3,1425,33,18523,FALSE
London,10/01/2022,34,17132,0,1425,34,18557,FALSE
London,11/01/2022,43,17175,1,1426,44,18601,FALSE
London,12/01/2022,23,17198,1,1427,24,18625,FALSE
London,13/01/2022,31,17229,0,1427,31,18656,FALSE
London,14/01/2022,32,17261,3,1430,35,18691,FALSE
London,15/01/2022,32,17293,1,1431,33,18724,FALSE
London,16/01/2022,29,17322,2,1433,31,18755,FALSE
London,17/01/2022,24,17346,0,1433,24,18779,FALSE
London,18/01/2022,26,17372,4,1437,30,18809,FALSE
London,19/01/2022,20,17392,1,1438,21,18830,FALSE
London,20/01/2022,21,17413,0,1438,21,18851,FALSE
London,21/01/2022,31,17444,2,1440,33,18884,FALSE
London,22/01/2022,24,17468,0,1440,24,18908,FALSE
London,23/01/2022,17,17485,1,1441,18,18926,FALSE
London,24/01/2022,25,17510,2,1443,27,18953,FALSE
London,25/01/2022,17,17527,2,1445,19,18972,FALSE
London,26/01/2022,20,17547,3,1448,23,18995,FALSE
London,27/01/2022,13,17560,1,1449,14,19009,FALSE
London,28/01/2022,18,17578,0,1449,18,19027,FALSE
London,29/01/2022,15,17593,0,1449,15,19042,FALSE
London,30/01/2022,15,17608,1,1450,16,19058,FALSE
London,31/01/2022,15,17623,0,1450,15,19073,FALSE
London,01/02/2022,10,17633,2,1452,12,19085,FALSE
London,02/02/2022,13,17646,0,1452,13,19098,TRUE
London,03/02/2022,5,17651,0,1452,5,19103,TRUE
London,04/02/2022,2,17653,0,1452,2,19105,TRUE
London,05/02/2022,0,17653,0,1452,0,19105,TRUE
London,06/02/2022,0,17653,0,1452,0,19105,TRUE
