nhs_england_region,date,new_deaths_with_positive_test,cumulative_deaths_with_positive_test,new_deaths_without_positive_test,cumulative_deaths_without_positive_test,new_deaths_total,cumulative_deaths_total,data_subject_to_change
North West,29/02/2020,0,0,0,0,0,0,FALSE
North West,01/03/2020,0,0,0,0,0,0,FALSE
North West,02/03/2020,0,0,0,0,0,0,FALSE
North West,03/03/2020,0,0,0,0,0,0,FALSE
North West,04/03/2020,0,0,0,0,0,0,FALSE
North West,05/03/2020,1,1,0,0,1,1,FALSE
North West,06/03/2020,0,1,0,0,0,1,FALSE
North West,07/03/2020,0,1,0,0,0,1,FALSE
North West,08/03/2020,1,2,0,0,1,2,FALSE
North West,09/03/2020,0,2,0,0,0,2,FALSE
North West,10/03/2020,0,2,0,0,0,2,FALSE
North West,11/03/2020,0,2,0,0,0,2,FALSE
North West,12/03/2020,2,4,0,0,2,4,FALSE
North West,13/03/2020,3,7,0,0,3,7,FALSE
North West,14/03/2020,1,8,0,0,1,8,FALSE
North West,15/03/2020,4,12,0,0,4,12,FALSE
North West,16/03/2020,2,14,0,0,2,14,FALSE
North West,17/03/2020,4,18,0,0,4,18,FALSE
North West,18/03/2020,6,24,0,0,6,24,FALSE
North West,19/03/2020,7,31,0,0,7,31,FALSE
North West,20/03/2020,10,41,0,0,10,41,FALSE
North West,21/03/2020,11,52,0,0,11,52,FALSE
North West,22/03/2020,13,65,0,0,13,65,FALSE
North West,23/03/2020,15,80,0,0,15,80,FALSE
North West,24/03/2020,21,101,0,0,21,101,FALSE
North West,25/03/2020,21,122,0,0,21,122,FALSE
North West,26/03/2020,29,151,0,0,29,151,FALSE
North West,27/03/2020,36,187,0,0,36,187,FALSE
North West,28/03/2020,28,215,0,0,28,215,FALSE
North West,29/03/2020,46,261,0,0,46,261,FALSE
North West,30/03/2020,67,328,0,0,67,328,FALSE
North West,31/03/2020,52,380,0,0,52,380,FALSE
North West,01/04/2020,86,466,0,0,86,466,FALSE
North West,02/04/2020,96,562,0,0,96,562,FALSE
North West,03/04/2020,95,657,0,0,95,657,FALSE
North West,04/04/2020,98,755,0,0,98,755,FALSE
North West,05/04/2020,102,857,0,0,102,857,FALSE
North West,06/04/2020,100,957,0,0,100,957,FALSE
North West,07/04/2020,136,1093,0,0,136,1093,FALSE
North West,08/04/2020,127,1220,0,0,127,1220,FALSE
North West,09/04/2020,119,1339,0,0,119,1339,FALSE
North West,10/04/2020,117,1456,0,0,117,1456,FALSE
North West,11/04/2020,139,1595,0,0,139,1595,FALSE
North West,12/04/2020,125,1720,0,0,125,1720,FALSE
North West,13/04/2020,130,1850,0,0,130,1850,FALSE
North West,14/04/2020,130,1980,1,1,131,1981,FALSE
North West,15/04/2020,114,2094,0,1,114,2095,FALSE
North West,16/04/2020,135,2229,0,1,135,2230,FALSE
North West,17/04/2020,98,2327,0,1,98,2328,FALSE
North West,18/04/2020,114,2441,0,1,114,2442,FALSE
North West,19/04/2020,71,2512,0,1,71,2513,FALSE
North West,20/04/2020,83,2595,0,1,83,2596,FALSE
North West,21/04/2020,76,2671,1,2,77,2673,FALSE
North West,22/04/2020,87,2758,0,2,87,2760,FALSE
North West,23/04/2020,85,2843,0,2,85,2845,FALSE
North West,24/04/2020,67,2910,3,5,70,2915,FALSE
North West,25/04/2020,67,2977,4,9,71,2986,FALSE
North West,26/04/2020,55,3032,2,11,57,3043,FALSE
North West,27/04/2020,54,3086,2,13,56,3099,FALSE
North West,28/04/2020,57,3143,2,15,59,3158,FALSE
North West,29/04/2020,64,3207,5,20,69,3227,FALSE
North West,30/04/2020,60,3267,4,24,64,3291,FALSE
North West,01/05/2020,45,3312,3,27,48,3339,FALSE
North West,02/05/2020,56,3368,1,28,57,3396,FALSE
North West,03/05/2020,55,3423,3,31,58,3454,FALSE
North West,04/05/2020,48,3471,4,35,52,3506,FALSE
North West,05/05/2020,49,3520,2,37,51,3557,FALSE
North West,06/05/2020,44,3564,4,41,48,3605,FALSE
North West,07/05/2020,50,3614,10,51,60,3665,FALSE
North West,08/05/2020,43,3657,5,56,48,3713,FALSE
North West,09/05/2020,31,3688,0,56,31,3744,FALSE
North West,10/05/2020,42,3730,3,59,45,3789,FALSE
North West,11/05/2020,35,3765,3,62,38,3827,FALSE
North West,12/05/2020,38,3803,2,64,40,3867,FALSE
North West,13/05/2020,25,3828,1,65,26,3893,FALSE
North West,14/05/2020,26,3854,5,70,31,3924,FALSE
North West,15/05/2020,33,3887,4,74,37,3961,FALSE
North West,16/05/2020,32,3919,0,74,32,3993,FALSE
North West,17/05/2020,24,3943,2,76,26,4019,FALSE
North West,18/05/2020,31,3974,1,77,32,4051,FALSE
North West,19/05/2020,35,4009,3,80,38,4089,FALSE
North West,20/05/2020,27,4036,3,83,30,4119,FALSE
North West,21/05/2020,28,4064,5,88,33,4152,FALSE
North West,22/05/2020,26,4090,2,90,28,4180,FALSE
North West,23/05/2020,31,4121,4,94,35,4215,FALSE
North West,24/05/2020,26,4147,3,97,29,4244,FALSE
North West,25/05/2020,31,4178,4,101,35,4279,FALSE
North West,26/05/2020,27,4205,3,104,30,4309,FALSE
North West,27/05/2020,27,4232,1,105,28,4337,FALSE
North West,28/05/2020,29,4261,1,106,30,4367,FALSE
North West,29/05/2020,20,4281,2,108,22,4389,FALSE
North West,30/05/2020,19,4300,1,109,20,4409,FALSE
North West,31/05/2020,13,4313,1,110,14,4423,FALSE
North West,01/06/2020,12,4325,0,110,12,4435,FALSE
North West,02/06/2020,27,4352,1,111,28,4463,FALSE
North West,03/06/2020,22,4374,3,114,25,4488,FALSE
North West,04/06/2020,22,4396,0,114,22,4510,FALSE
North West,05/06/2020,16,4412,1,115,17,4527,FALSE
North West,06/06/2020,26,4438,0,115,26,4553,FALSE
North West,07/06/2020,20,4458,1,116,21,4574,FALSE
North West,08/06/2020,23,4481,0,116,23,4597,FALSE
North West,09/06/2020,17,4498,0,116,17,4614,FALSE
North West,10/06/2020,16,4514,5,121,21,4635,FALSE
North West,11/06/2020,16,4530,0,121,16,4651,FALSE
North West,12/06/2020,11,4541,1,122,12,4663,FALSE
North West,13/06/2020,10,4551,0,122,10,4673,FALSE
North West,14/06/2020,15,4566,0,122,15,4688,FALSE
North West,15/06/2020,16,4582,1,123,17,4705,FALSE
North West,16/06/2020,16,4598,1,124,17,4722,FALSE
North West,17/06/2020,13,4611,1,125,14,4736,FALSE
North West,18/06/2020,14,4625,1,126,15,4751,FALSE
North West,19/06/2020,7,4632,0,126,7,4758,FALSE
North West,20/06/2020,11,4643,1,127,12,4770,FALSE
North West,21/06/2020,8,4651,0,127,8,4778,FALSE
North West,22/06/2020,11,4662,1,128,12,4790,FALSE
North West,23/06/2020,13,4675,1,129,14,4804,FALSE
North West,24/06/2020,13,4688,1,130,14,4818,FALSE
North West,25/06/2020,15,4703,0,130,15,4833,FALSE
North West,26/06/2020,6,4709,2,132,8,4841,FALSE
North West,27/06/2020,7,4716,0,132,7,4848,FALSE
North West,28/06/2020,9,4725,0,132,9,4857,FALSE
North West,29/06/2020,9,4734,0,132,9,4866,FALSE
North West,30/06/2020,7,4741,1,133,8,4874,FALSE
North West,01/07/2020,3,4744,3,136,6,4880,FALSE
North West,02/07/2020,6,4750,3,139,9,4889,FALSE
North West,03/07/2020,7,4757,0,139,7,4896,FALSE
North West,04/07/2020,4,4761,1,140,5,4901,FALSE
North West,05/07/2020,6,4767,0,140,6,4907,FALSE
North West,06/07/2020,9,4776,0,140,9,4916,FALSE
North West,07/07/2020,8,4784,0,140,8,4924,FALSE
North West,08/07/2020,5,4789,2,142,7,4931,FALSE
North West,09/07/2020,10,4799,1,143,11,4942,FALSE
North West,10/07/2020,2,4801,0,143,2,4944,FALSE
North West,11/07/2020,5,4806,0,143,5,4949,FALSE
North West,12/07/2020,0,4806,1,144,1,4950,FALSE
North West,13/07/2020,6,4812,1,145,7,4957,FALSE
North West,14/07/2020,4,4816,0,145,4,4961,FALSE
North West,15/07/2020,5,4821,1,146,6,4967,FALSE
North West,16/07/2020,2,4823,3,149,5,4972,FALSE
North West,17/07/2020,4,4827,2,151,6,4978,FALSE
North West,18/07/2020,5,4832,0,151,5,4983,FALSE
North West,19/07/2020,3,4835,0,151,3,4986,FALSE
North West,20/07/2020,0,4835,2,153,2,4988,FALSE
North West,21/07/2020,2,4837,2,155,4,4992,FALSE
North West,22/07/2020,3,4840,0,155,3,4995,FALSE
North West,23/07/2020,3,4843,4,159,7,5002,FALSE
North West,24/07/2020,1,4844,0,159,1,5003,FALSE
North West,25/07/2020,1,4845,2,161,3,5006,FALSE
North West,26/07/2020,3,4848,1,162,4,5010,FALSE
North West,27/07/2020,1,4849,1,163,2,5012,FALSE
North West,28/07/2020,1,4850,2,165,3,5015,FALSE
North West,29/07/2020,2,4852,0,165,2,5017,FALSE
North West,30/07/2020,2,4854,0,165,2,5019,FALSE
North West,31/07/2020,0,4854,1,166,1,5020,FALSE
North West,01/08/2020,2,4856,1,167,3,5023,FALSE
North West,02/08/2020,1,4857,0,167,1,5024,FALSE
North West,03/08/2020,8,4865,0,167,8,5032,FALSE
North West,04/08/2020,3,4868,2,169,5,5037,FALSE
North West,05/08/2020,2,4870,0,169,2,5039,FALSE
North West,06/08/2020,2,4872,2,171,4,5043,FALSE
North West,07/08/2020,2,4874,0,171,2,5045,FALSE
North West,08/08/2020,2,4876,0,171,2,5047,FALSE
North West,09/08/2020,3,4879,1,172,4,5051,FALSE
North West,10/08/2020,2,4881,0,172,2,5053,FALSE
North West,11/08/2020,3,4884,0,172,3,5056,FALSE
North West,12/08/2020,0,4884,2,174,2,5058,FALSE
North West,13/08/2020,2,4886,0,174,2,5060,FALSE
North West,14/08/2020,2,4888,2,176,4,5064,FALSE
North West,15/08/2020,6,4894,1,177,7,5071,FALSE
North West,16/08/2020,2,4896,2,179,4,5075,FALSE
North West,17/08/2020,1,4897,2,181,3,5078,FALSE
North West,18/08/2020,2,4899,0,181,2,5080,FALSE
North West,19/08/2020,1,4900,0,181,1,5081,FALSE
North West,20/08/2020,1,4901,1,182,2,5083,FALSE
North West,21/08/2020,4,4905,0,182,4,5087,FALSE
North West,22/08/2020,3,4908,0,182,3,5090,FALSE
North West,23/08/2020,5,4913,1,183,6,5096,FALSE
North West,24/08/2020,4,4917,0,183,4,5100,FALSE
North West,25/08/2020,3,4920,3,186,6,5106,FALSE
North West,26/08/2020,4,4924,0,186,4,5110,FALSE
North West,27/08/2020,1,4925,0,186,1,5111,FALSE
North West,28/08/2020,2,4927,0,186,2,5113,FALSE
North West,29/08/2020,0,4927,0,186,0,5113,FALSE
North West,30/08/2020,2,4929,0,186,2,5115,FALSE
North West,31/08/2020,3,4932,1,187,4,5119,FALSE
North West,01/09/2020,0,4932,1,188,1,5120,FALSE
North West,02/09/2020,2,4934,0,188,2,5122,FALSE
North West,03/09/2020,1,4935,0,188,1,5123,FALSE
North West,04/09/2020,3,4938,0,188,3,5126,FALSE
North West,05/09/2020,6,4944,0,188,6,5132,FALSE
North West,06/09/2020,1,4945,2,190,3,5135,FALSE
North West,07/09/2020,8,4953,0,190,8,5143,FALSE
North West,08/09/2020,6,4959,0,190,6,5149,FALSE
North West,09/09/2020,5,4964,0,190,5,5154,FALSE
North West,10/09/2020,5,4969,0,190,5,5159,FALSE
North West,11/09/2020,1,4970,1,191,2,5161,FALSE
North West,12/09/2020,4,4974,1,192,5,5166,FALSE
North West,13/09/2020,2,4976,1,193,3,5169,FALSE
North West,14/09/2020,4,4980,1,194,5,5174,FALSE
North West,15/09/2020,4,4984,0,194,4,5178,FALSE
North West,16/09/2020,6,4990,1,195,7,5185,FALSE
North West,17/09/2020,7,4997,1,196,8,5193,FALSE
North West,18/09/2020,6,5003,0,196,6,5199,FALSE
North West,19/09/2020,3,5006,1,197,4,5203,FALSE
North West,20/09/2020,2,5008,1,198,3,5206,FALSE
North West,21/09/2020,2,5010,0,198,2,5208,FALSE
North West,22/09/2020,9,5019,1,199,10,5218,FALSE
North West,23/09/2020,14,5033,3,202,17,5235,FALSE
North West,24/09/2020,10,5043,1,203,11,5246,FALSE
North West,25/09/2020,8,5051,0,203,8,5254,FALSE
North West,26/09/2020,14,5065,3,206,17,5271,FALSE
North West,27/09/2020,11,5076,2,208,13,5284,FALSE
North West,28/09/2020,15,5091,2,210,17,5301,FALSE
North West,29/09/2020,12,5103,4,214,16,5317,FALSE
North West,30/09/2020,17,5120,3,217,20,5337,FALSE
North West,01/10/2020,17,5137,1,218,18,5355,FALSE
North West,02/10/2020,20,5157,2,220,22,5377,FALSE
North West,03/10/2020,15,5172,0,220,15,5392,FALSE
North West,04/10/2020,15,5187,3,223,18,5410,FALSE
North West,05/10/2020,15,5202,2,225,17,5427,FALSE
North West,06/10/2020,20,5222,2,227,22,5449,FALSE
North West,07/10/2020,20,5242,3,230,23,5472,FALSE
North West,08/10/2020,22,5264,1,231,23,5495,FALSE
North West,09/10/2020,24,5288,4,235,28,5523,FALSE
North West,10/10/2020,31,5319,0,235,31,5554,FALSE
North West,11/10/2020,31,5350,1,236,32,5586,FALSE
North West,12/10/2020,35,5385,0,236,35,5621,FALSE
North West,13/10/2020,26,5411,1,237,27,5648,FALSE
North West,14/10/2020,35,5446,0,237,35,5683,FALSE
North West,15/10/2020,36,5482,1,238,37,5720,FALSE
North West,16/10/2020,34,5516,3,241,37,5757,FALSE
North West,17/10/2020,52,5568,4,245,56,5813,FALSE
North West,18/10/2020,40,5608,1,246,41,5854,FALSE
North West,19/10/2020,43,5651,2,248,45,5899,FALSE
North West,20/10/2020,48,5699,3,251,51,5950,FALSE
North West,21/10/2020,51,5750,3,254,54,6004,FALSE
North West,22/10/2020,49,5799,0,254,49,6053,FALSE
North West,23/10/2020,50,5849,3,257,53,6106,FALSE
North West,24/10/2020,51,5900,10,267,61,6167,FALSE
North West,25/10/2020,63,5963,6,273,69,6236,FALSE
North West,26/10/2020,53,6016,4,277,57,6293,FALSE
North West,27/10/2020,49,6065,1,278,50,6343,FALSE
North West,28/10/2020,57,6122,2,280,59,6402,FALSE
North West,29/10/2020,74,6196,4,284,78,6480,FALSE
North West,30/10/2020,73,6269,4,288,77,6557,FALSE
North West,31/10/2020,63,6332,4,292,67,6624,FALSE
North West,01/11/2020,76,6408,1,293,77,6701,FALSE
North West,02/11/2020,65,6473,3,296,68,6769,FALSE
North West,03/11/2020,77,6550,4,300,81,6850,FALSE
North West,04/11/2020,64,6614,3,303,67,6917,FALSE
North West,05/11/2020,67,6681,4,307,71,6988,FALSE
North West,06/11/2020,76,6757,2,309,78,7066,FALSE
North West,07/11/2020,79,6836,1,310,80,7146,FALSE
North West,08/11/2020,83,6919,4,314,87,7233,FALSE
North West,09/11/2020,82,7001,5,319,87,7320,FALSE
North West,10/11/2020,68,7069,4,323,72,7392,FALSE
North West,11/11/2020,62,7131,3,326,65,7457,FALSE
North West,12/11/2020,64,7195,3,329,67,7524,FALSE
North West,13/11/2020,81,7276,6,335,87,7611,FALSE
North West,14/11/2020,62,7338,1,336,63,7674,FALSE
North West,15/11/2020,75,7413,1,337,76,7750,FALSE
North West,16/11/2020,74,7487,5,342,79,7829,FALSE
North West,17/11/2020,73,7560,2,344,75,7904,FALSE
North West,18/11/2020,71,7631,5,349,76,7980,FALSE
North West,19/11/2020,67,7698,4,353,71,8051,FALSE
North West,20/11/2020,52,7750,6,359,58,8109,FALSE
North West,21/11/2020,68,7818,4,363,72,8181,FALSE
North West,22/11/2020,52,7870,5,368,57,8238,FALSE
North West,23/11/2020,54,7924,3,371,57,8295,FALSE
North West,24/11/2020,64,7988,5,376,69,8364,FALSE
North West,25/11/2020,65,8053,2,378,67,8431,FALSE
North West,26/11/2020,53,8106,2,380,55,8486,FALSE
North West,27/11/2020,51,8157,3,383,54,8540,FALSE
North West,28/11/2020,46,8203,6,389,52,8592,FALSE
North West,29/11/2020,54,8257,3,392,57,8649,FALSE
North West,30/11/2020,48,8305,3,395,51,8700,FALSE
North West,01/12/2020,53,8358,7,402,60,8760,FALSE
North West,02/12/2020,48,8406,5,407,53,8813,FALSE
North West,03/12/2020,47,8453,3,410,50,8863,FALSE
North West,04/12/2020,48,8501,3,413,51,8914,FALSE
North West,05/12/2020,37,8538,3,416,40,8954,FALSE
North West,06/12/2020,43,8581,4,420,47,9001,FALSE
North West,07/12/2020,50,8631,4,424,54,9055,FALSE
North West,08/12/2020,49,8680,5,429,54,9109,FALSE
North West,09/12/2020,48,8728,5,434,53,9162,FALSE
North West,10/12/2020,49,8777,1,435,50,9212,FALSE
North West,11/12/2020,41,8818,5,440,46,9258,FALSE
North West,12/12/2020,48,8866,3,443,51,9309,FALSE
North West,13/12/2020,42,8908,2,445,44,9353,FALSE
North West,14/12/2020,51,8959,3,448,54,9407,FALSE
North West,15/12/2020,34,8993,3,451,37,9444,FALSE
North West,16/12/2020,41,9034,2,453,43,9487,FALSE
North West,17/12/2020,26,9060,3,456,29,9516,FALSE
North West,18/12/2020,47,9107,3,459,50,9566,FALSE
North West,19/12/2020,45,9152,2,461,47,9613,FALSE
North West,20/12/2020,37,9189,4,465,41,9654,FALSE
North West,21/12/2020,51,9240,4,469,55,9709,FALSE
North West,22/12/2020,52,9292,3,472,55,9764,FALSE
North West,23/12/2020,50,9342,2,474,52,9816,FALSE
North West,24/12/2020,58,9400,4,478,62,9878,FALSE
North West,25/12/2020,52,9452,0,478,52,9930,FALSE
North West,26/12/2020,56,9508,5,483,61,9991,FALSE
North West,27/12/2020,50,9558,2,485,52,10043,FALSE
North West,28/12/2020,48,9606,3,488,51,10094,FALSE
North West,29/12/2020,49,9655,3,491,52,10146,FALSE
North West,30/12/2020,49,9704,4,495,53,10199,FALSE
North West,31/12/2020,62,9766,4,499,66,10265,FALSE
North West,01/01/2021,54,9820,3,502,57,10322,FALSE
North West,02/01/2021,55,9875,7,509,62,10384,FALSE
North West,03/01/2021,57,9932,2,511,59,10443,FALSE
North West,04/01/2021,51,9983,3,514,54,10497,FALSE
North West,05/01/2021,56,10039,6,520,62,10559,FALSE
North West,06/01/2021,69,10108,4,524,73,10632,FALSE
North West,07/01/2021,61,10169,5,529,66,10698,FALSE
North West,08/01/2021,65,10234,1,530,66,10764,FALSE
North West,09/01/2021,70,10304,4,534,74,10838,FALSE
North West,10/01/2021,66,10370,5,539,71,10909,FALSE
North West,11/01/2021,79,10449,3,542,82,10991,FALSE
North West,12/01/2021,66,10515,4,546,70,11061,FALSE
North West,13/01/2021,85,10600,6,552,91,11152,FALSE
North West,14/01/2021,93,10693,7,559,100,11252,FALSE
North West,15/01/2021,87,10780,2,561,89,11341,FALSE
North West,16/01/2021,83,10863,4,565,87,11428,FALSE
North West,17/01/2021,81,10944,6,571,87,11515,FALSE
North West,18/01/2021,92,11036,4,575,96,11611,FALSE
North West,19/01/2021,92,11128,8,583,100,11711,FALSE
North West,20/01/2021,89,11217,5,588,94,11805,FALSE
North West,21/01/2021,85,11302,5,593,90,11895,FALSE
North West,22/01/2021,110,11412,4,597,114,12009,FALSE
North West,23/01/2021,103,11515,1,598,104,12113,FALSE
North West,24/01/2021,96,11611,5,603,101,12214,FALSE
North West,25/01/2021,86,11697,4,607,90,12304,FALSE
North West,26/01/2021,103,11800,3,610,106,12410,FALSE
North West,27/01/2021,104,11904,8,618,112,12522,FALSE
North West,28/01/2021,103,12007,1,619,104,12626,FALSE
North West,29/01/2021,101,12108,4,623,105,12731,FALSE
North West,30/01/2021,79,12187,2,625,81,12812,FALSE
North West,31/01/2021,87,12274,7,632,94,12906,FALSE
North West,01/02/2021,96,12370,6,638,102,13008,FALSE
North West,02/02/2021,82,12452,3,641,85,13093,FALSE
North West,03/02/2021,71,12523,5,646,76,13169,FALSE
North West,04/02/2021,79,12602,6,652,85,13254,FALSE
North West,05/02/2021,67,12669,3,655,70,13324,FALSE
North West,06/02/2021,62,12731,3,658,65,13389,FALSE
North West,07/02/2021,53,12784,2,660,55,13444,FALSE
North West,08/02/2021,74,12858,4,664,78,13522,FALSE
North West,09/02/2021,69,12927,5,669,74,13596,FALSE
North West,10/02/2021,72,12999,4,673,76,13672,FALSE
North West,11/02/2021,68,13067,5,678,73,13745,FALSE
North West,12/02/2021,67,13134,3,681,70,13815,FALSE
North West,13/02/2021,62,13196,6,687,68,13883,FALSE
North West,14/02/2021,51,13247,7,694,58,13941,FALSE
North West,15/02/2021,57,13304,7,701,64,14005,FALSE
North West,16/02/2021,55,13359,5,706,60,14065,FALSE
North West,17/02/2021,55,13414,1,707,56,14121,FALSE
North West,18/02/2021,52,13466,5,712,57,14178,FALSE
North West,19/02/2021,40,13506,3,715,43,14221,FALSE
North West,20/02/2021,34,13540,2,717,36,14257,FALSE
North West,21/02/2021,36,13576,7,724,43,14300,FALSE
North West,22/02/2021,26,13602,5,729,31,14331,FALSE
North West,23/02/2021,36,13638,3,732,39,14370,FALSE
North West,24/02/2021,35,13673,6,738,41,14411,FALSE
North West,25/02/2021,22,13695,4,742,26,14437,FALSE
North West,26/02/2021,38,13733,3,745,41,14478,FALSE
North West,27/02/2021,26,13759,3,748,29,14507,FALSE
North West,28/02/2021,32,13791,3,751,35,14542,FALSE
North West,01/03/2021,32,13823,3,754,35,14577,FALSE
North West,02/03/2021,13,13836,7,761,20,14597,FALSE
North West,03/03/2021,23,13859,4,765,27,14624,FALSE
North West,04/03/2021,12,13871,5,770,17,14641,FALSE
North West,05/03/2021,25,13896,2,772,27,14668,FALSE
North West,06/03/2021,15,13911,2,774,17,14685,FALSE
North West,07/03/2021,23,13934,3,777,26,14711,FALSE
North West,08/03/2021,16,13950,4,781,20,14731,FALSE
North West,09/03/2021,14,13964,3,784,17,14748,FALSE
North West,10/03/2021,13,13977,5,789,18,14766,FALSE
North West,11/03/2021,17,13994,1,790,18,14784,FALSE
North West,12/03/2021,10,14004,2,792,12,14796,FALSE
North West,13/03/2021,11,14015,0,792,11,14807,FALSE
North West,14/03/2021,20,14035,1,793,21,14828,FALSE
North West,15/03/2021,16,14051,3,796,19,14847,FALSE
North West,16/03/2021,12,14063,4,800,16,14863,FALSE
North West,17/03/2021,12,14075,3,803,15,14878,FALSE
North West,18/03/2021,4,14079,1,804,5,14883,FALSE
North West,19/03/2021,13,14092,1,805,14,14897,FALSE
North West,20/03/2021,13,14105,2,807,15,14912,FALSE
North West,21/03/2021,10,14115,3,810,13,14925,FALSE
North West,22/03/2021,7,14122,5,815,12,14937,FALSE
North West,23/03/2021,12,14134,1,816,13,14950,FALSE
North West,24/03/2021,4,14138,0,816,4,14954,FALSE
North West,25/03/2021,11,14149,0,816,11,14965,FALSE
North West,26/03/2021,6,14155,0,816,6,14971,FALSE
North West,27/03/2021,1,14156,0,816,1,14972,FALSE
North West,28/03/2021,5,14161,3,819,8,14980,FALSE
North West,29/03/2021,8,14169,1,820,9,14989,FALSE
North West,30/03/2021,5,14174,2,822,7,14996,FALSE
North West,31/03/2021,5,14179,2,824,7,15003,FALSE
North West,01/04/2021,5,14184,3,827,8,15011,FALSE
North West,02/04/2021,2,14186,2,829,4,15015,FALSE
North West,03/04/2021,4,14190,0,829,4,15019,FALSE
North West,04/04/2021,4,14194,2,831,6,15025,FALSE
North West,05/04/2021,2,14196,1,832,3,15028,FALSE
North West,06/04/2021,1,14197,0,832,1,15029,FALSE
North West,07/04/2021,4,14201,2,834,6,15035,FALSE
North West,08/04/2021,6,14207,0,834,6,15041,FALSE
North West,09/04/2021,7,14214,0,834,7,15048,FALSE
North West,10/04/2021,5,14219,0,834,5,15053,FALSE
North West,11/04/2021,1,14220,3,837,4,15057,FALSE
North West,12/04/2021,7,14227,0,837,7,15064,FALSE
North West,13/04/2021,4,14231,2,839,6,15070,FALSE
North West,14/04/2021,2,14233,2,841,4,15074,FALSE
North West,15/04/2021,0,14233,1,842,1,15075,FALSE
North West,16/04/2021,2,14235,2,844,4,15079,FALSE
North West,17/04/2021,1,14236,1,845,2,15081,FALSE
North West,18/04/2021,1,14237,0,845,1,15082,FALSE
North West,19/04/2021,1,14238,0,845,1,15083,FALSE
North West,20/04/2021,4,14242,1,846,5,15088,FALSE
North West,21/04/2021,3,14245,2,848,5,15093,FALSE
North West,22/04/2021,4,14249,0,848,4,15097,FALSE
North West,23/04/2021,1,14250,0,848,1,15098,FALSE
North West,24/04/2021,3,14253,0,848,3,15101,FALSE
North West,25/04/2021,1,14254,0,848,1,15102,FALSE
North West,26/04/2021,5,14259,0,848,5,15107,FALSE
North West,27/04/2021,0,14259,3,851,3,15110,FALSE
North West,28/04/2021,2,14261,1,852,3,15113,FALSE
North West,29/04/2021,4,14265,0,852,4,15117,FALSE
North West,30/04/2021,0,14265,0,852,0,15117,FALSE
North West,01/05/2021,1,14266,0,852,1,15118,FALSE
North West,02/05/2021,1,14267,0,852,1,15119,FALSE
North West,03/05/2021,0,14267,0,852,0,15119,FALSE
North West,04/05/2021,1,14268,0,852,1,15120,FALSE
North West,05/05/2021,1,14269,2,854,3,15123,FALSE
North West,06/05/2021,1,14270,0,854,1,15124,FALSE
North West,07/05/2021,0,14270,0,854,0,15124,FALSE
North West,08/05/2021,0,14270,0,854,0,15124,FALSE
North West,09/05/2021,1,14271,0,854,1,15125,FALSE
North West,10/05/2021,1,14272,0,854,1,15126,FALSE
North West,11/05/2021,5,14277,1,855,6,15132,FALSE
North West,12/05/2021,0,14277,0,855,0,15132,FALSE
North West,13/05/2021,0,14277,2,857,2,15134,FALSE
North West,14/05/2021,0,14277,0,857,0,15134,FALSE
North West,15/05/2021,1,14278,0,857,1,15135,FALSE
North West,16/05/2021,1,14279,0,857,1,15136,FALSE
North West,17/05/2021,1,14280,0,857,1,15137,FALSE
North West,18/05/2021,0,14280,1,858,1,15138,FALSE
North West,19/05/2021,1,14281,0,858,1,15139,FALSE
North West,20/05/2021,1,14282,0,858,1,15140,FALSE
North West,21/05/2021,3,14285,0,858,3,15143,FALSE
North West,22/05/2021,1,14286,0,858,1,15144,FALSE
North West,23/05/2021,3,14289,0,858,3,15147,FALSE
North West,24/05/2021,3,14292,0,858,3,15150,FALSE
North West,25/05/2021,0,14292,0,858,0,15150,FALSE
North West,26/05/2021,2,14294,0,858,2,15152,FALSE
North West,27/05/2021,3,14297,1,859,4,15156,FALSE
North West,28/05/2021,2,14299,1,860,3,15159,FALSE
North West,29/05/2021,1,14300,2,862,3,15162,FALSE
North West,30/05/2021,1,14301,0,862,1,15163,FALSE
North West,31/05/2021,3,14304,0,862,3,15166,FALSE
North West,01/06/2021,1,14305,0,862,1,15167,FALSE
North West,02/06/2021,2,14307,0,862,2,15169,FALSE
North West,03/06/2021,6,14313,0,862,6,15175,FALSE
North West,04/06/2021,0,14313,0,862,0,15175,FALSE
North West,05/06/2021,3,14316,0,862,3,15178,FALSE
North West,06/06/2021,1,14317,0,862,1,15179,FALSE
North West,07/06/2021,1,14318,0,862,1,15180,FALSE
North West,08/06/2021,2,14320,1,863,3,15183,FALSE
North West,09/06/2021,3,14323,0,863,3,15186,FALSE
North West,10/06/2021,1,14324,0,863,1,15187,FALSE
North West,11/06/2021,3,14327,1,864,4,15191,FALSE
North West,12/06/2021,1,14328,0,864,1,15192,FALSE
North West,13/06/2021,0,14328,0,864,0,15192,FALSE
North West,14/06/2021,6,14334,0,864,6,15198,FALSE
North West,15/06/2021,6,14340,0,864,6,15204,FALSE
North West,16/06/2021,4,14344,0,864,4,15208,FALSE
North West,17/06/2021,1,14345,0,864,1,15209,FALSE
North West,18/06/2021,5,14350,0,864,5,15214,FALSE
North West,19/06/2021,7,14357,0,864,7,15221,FALSE
North West,20/06/2021,8,14365,0,864,8,15229,FALSE
North West,21/06/2021,8,14373,2,866,10,15239,FALSE
North West,22/06/2021,3,14376,1,867,4,15243,FALSE
North West,23/06/2021,4,14380,0,867,4,15247,FALSE
North West,24/06/2021,9,14389,1,868,10,15257,FALSE
North West,25/06/2021,6,14395,0,868,6,15263,FALSE
North West,26/06/2021,1,14396,0,868,1,15264,FALSE
North West,27/06/2021,4,14400,0,868,4,15268,FALSE
North West,28/06/2021,5,14405,1,869,6,15274,FALSE
North West,29/06/2021,4,14409,0,869,4,15278,FALSE
North West,30/06/2021,10,14419,0,869,10,15288,FALSE
North West,01/07/2021,2,14421,0,869,2,15290,FALSE
North West,02/07/2021,14,14435,0,869,14,15304,FALSE
North West,03/07/2021,5,14440,0,869,5,15309,FALSE
North West,04/07/2021,5,14445,1,870,6,15315,FALSE
North West,05/07/2021,7,14452,1,871,8,15323,FALSE
North West,06/07/2021,7,14459,0,871,7,15330,FALSE
North West,07/07/2021,6,14465,1,872,7,15337,FALSE
North West,08/07/2021,10,14475,1,873,11,15348,FALSE
North West,09/07/2021,11,14486,1,874,12,15360,FALSE
North West,10/07/2021,5,14491,1,875,6,15366,FALSE
North West,11/07/2021,11,14502,0,875,11,15377,FALSE
North West,12/07/2021,6,14508,1,876,7,15384,FALSE
North West,13/07/2021,13,14521,2,878,15,15399,FALSE
North West,14/07/2021,8,14529,0,878,8,15407,FALSE
North West,15/07/2021,10,14539,0,878,10,15417,FALSE
North West,16/07/2021,15,14554,0,878,15,15432,FALSE
North West,17/07/2021,10,14564,0,878,10,15442,FALSE
North West,18/07/2021,11,14575,1,879,12,15454,FALSE
North West,19/07/2021,13,14588,1,880,14,15468,FALSE
North West,20/07/2021,12,14600,1,881,13,15481,FALSE
North West,21/07/2021,9,14609,0,881,9,15490,FALSE
North West,22/07/2021,21,14630,2,883,23,15513,FALSE
North West,23/07/2021,9,14639,0,883,9,15522,FALSE
North West,24/07/2021,6,14645,0,883,6,15528,FALSE
North West,25/07/2021,9,14654,0,883,9,15537,FALSE
North West,26/07/2021,16,14670,2,885,18,15555,FALSE
North West,27/07/2021,12,14682,0,885,12,15567,FALSE
North West,28/07/2021,12,14694,0,885,12,15579,FALSE
North West,29/07/2021,12,14706,1,886,13,15592,FALSE
North West,30/07/2021,17,14723,1,887,18,15610,FALSE
North West,31/07/2021,12,14735,0,887,12,15622,FALSE
North West,01/08/2021,13,14748,1,888,14,15636,FALSE
North West,02/08/2021,11,14759,1,889,12,15648,FALSE
North West,03/08/2021,8,14767,0,889,8,15656,FALSE
North West,04/08/2021,10,14777,3,892,13,15669,FALSE
North West,05/08/2021,13,14790,1,893,14,15683,FALSE
North West,06/08/2021,7,14797,1,894,8,15691,FALSE
North West,07/08/2021,15,14812,1,895,16,15707,FALSE
North West,08/08/2021,12,14824,0,895,12,15719,FALSE
North West,09/08/2021,9,14833,1,896,10,15729,FALSE
North West,10/08/2021,13,14846,0,896,13,15742,FALSE
North West,11/08/2021,15,14861,2,898,17,15759,FALSE
North West,12/08/2021,10,14871,2,900,12,15771,FALSE
North West,13/08/2021,9,14880,0,900,9,15780,FALSE
North West,14/08/2021,13,14893,2,902,15,15795,FALSE
North West,15/08/2021,8,14901,1,903,9,15804,FALSE
North West,16/08/2021,9,14910,0,903,9,15813,FALSE
North West,17/08/2021,10,14920,0,903,10,15823,FALSE
North West,18/08/2021,6,14926,0,903,6,15829,FALSE
North West,19/08/2021,14,14940,1,904,15,15844,FALSE
North West,20/08/2021,18,14958,1,905,19,15863,FALSE
North West,21/08/2021,16,14974,0,905,16,15879,FALSE
North West,22/08/2021,9,14983,1,906,10,15889,FALSE
North West,23/08/2021,12,14995,0,906,12,15901,FALSE
North West,24/08/2021,21,15016,4,910,25,15926,FALSE
North West,25/08/2021,9,15025,0,910,9,15935,FALSE
North West,26/08/2021,11,15036,4,914,15,15950,FALSE
North West,27/08/2021,11,15047,0,914,11,15961,FALSE
North West,28/08/2021,12,15059,1,915,13,15974,FALSE
North West,29/08/2021,9,15068,0,915,9,15983,FALSE
North West,30/08/2021,9,15077,1,916,10,15993,FALSE
North West,31/08/2021,16,15093,1,917,17,16010,FALSE
North West,01/09/2021,9,15102,0,917,9,16019,FALSE
North West,02/09/2021,12,15114,1,918,13,16032,FALSE
North West,03/09/2021,17,15131,0,918,17,16049,FALSE
North West,04/09/2021,11,15142,1,919,12,16061,FALSE
North West,05/09/2021,17,15159,0,919,17,16078,FALSE
North West,06/09/2021,14,15173,0,919,14,16092,FALSE
North West,07/09/2021,16,15189,1,920,17,16109,FALSE
North West,08/09/2021,18,15207,1,921,19,16128,FALSE
North West,09/09/2021,15,15222,2,923,17,16145,FALSE
North West,10/09/2021,19,15241,3,926,22,16167,FALSE
North West,11/09/2021,13,15254,1,927,14,16181,FALSE
North West,12/09/2021,10,15264,2,929,12,16193,FALSE
North West,13/09/2021,8,15272,1,930,9,16202,FALSE
North West,14/09/2021,15,15287,0,930,15,16217,FALSE
North West,15/09/2021,20,15307,0,930,20,16237,FALSE
North West,16/09/2021,17,15324,5,935,22,16259,FALSE
North West,17/09/2021,15,15339,3,938,18,16277,FALSE
North West,18/09/2021,18,15357,0,938,18,16295,FALSE
North West,19/09/2021,13,15370,0,938,13,16308,FALSE
North West,20/09/2021,11,15381,1,939,12,16320,FALSE
North West,21/09/2021,11,15392,1,940,12,16332,FALSE
North West,22/09/2021,12,15404,1,941,13,16345,FALSE
North West,23/09/2021,17,15421,1,942,18,16363,FALSE
North West,24/09/2021,9,15430,1,943,10,16373,FALSE
North West,25/09/2021,14,15444,4,947,18,16391,FALSE
North West,26/09/2021,7,15451,0,947,7,16398,FALSE
North West,27/09/2021,5,15456,1,948,6,16404,FALSE
North West,28/09/2021,11,15467,0,948,11,16415,FALSE
North West,29/09/2021,7,15474,1,949,8,16423,FALSE
North West,30/09/2021,12,15486,1,950,13,16436,FALSE
North West,01/10/2021,12,15498,0,950,12,16448,FALSE
North West,02/10/2021,12,15510,2,952,14,16462,FALSE
North West,03/10/2021,17,15527,1,953,18,16480,FALSE
North West,04/10/2021,11,15538,2,955,13,16493,FALSE
North West,05/10/2021,11,15549,1,956,12,16505,FALSE
North West,06/10/2021,12,15561,0,956,12,16517,FALSE
North West,07/10/2021,9,15570,2,958,11,16528,FALSE
North West,08/10/2021,5,15575,1,959,6,16534,FALSE
North West,09/10/2021,11,15586,1,960,12,16546,FALSE
North West,10/10/2021,11,15597,2,962,13,16559,FALSE
North West,11/10/2021,14,15611,2,964,16,16575,FALSE
North West,12/10/2021,10,15621,0,964,10,16585,FALSE
North West,13/10/2021,12,15633,0,964,12,16597,FALSE
North West,14/10/2021,13,15646,2,966,15,16612,FALSE
North West,15/10/2021,14,15660,2,968,16,16628,FALSE
North West,16/10/2021,17,15677,1,969,18,16646,FALSE
North West,17/10/2021,15,15692,0,969,15,16661,FALSE
North West,18/10/2021,15,15707,2,971,17,16678,FALSE
North West,19/10/2021,8,15715,2,973,10,16688,FALSE
North West,20/10/2021,18,15733,4,977,22,16710,FALSE
North West,21/10/2021,22,15755,3,980,25,16735,FALSE
North West,22/10/2021,12,15767,2,982,14,16749,FALSE
North West,23/10/2021,14,15781,0,982,14,16763,FALSE
North West,24/10/2021,19,15800,1,983,20,16783,FALSE
North West,25/10/2021,15,15815,3,986,18,16801,FALSE
North West,26/10/2021,13,15828,0,986,13,16814,FALSE
North West,27/10/2021,14,15842,0,986,14,16828,FALSE
North West,28/10/2021,24,15866,1,987,25,16853,FALSE
North West,29/10/2021,16,15882,1,988,17,16870,FALSE
North West,30/10/2021,23,15905,0,988,23,16893,FALSE
North West,31/10/2021,19,15924,0,988,19,16912,FALSE
North West,01/11/2021,15,15939,1,989,16,16928,FALSE
North West,02/11/2021,10,15949,0,989,10,16938,FALSE
North West,03/11/2021,28,15977,1,990,29,16967,FALSE
North West,04/11/2021,25,16002,1,991,26,16993,FALSE
North West,05/11/2021,6,16008,0,991,6,16999,FALSE
North West,06/11/2021,33,16041,1,992,34,17033,FALSE
North West,07/11/2021,16,16057,0,992,16,17049,FALSE
North West,08/11/2021,21,16078,0,992,21,17070,FALSE
North West,09/11/2021,14,16092,3,995,17,17087,FALSE
North West,10/11/2021,20,16112,2,997,22,17109,FALSE
North West,11/11/2021,14,16126,2,999,16,17125,FALSE
North West,12/11/2021,9,16135,2,1001,11,17136,FALSE
North West,13/11/2021,18,16153,1,1002,19,17155,FALSE
North West,14/11/2021,13,16166,1,1003,14,17169,FALSE
North West,15/11/2021,23,16189,3,1006,26,17195,FALSE
North West,16/11/2021,27,16216,2,1008,29,17224,FALSE
North West,17/11/2021,19,16235,1,1009,20,17244,FALSE
North West,18/11/2021,13,16248,1,1010,14,17258,FALSE
North West,19/11/2021,14,16262,0,1010,14,17272,FALSE
North West,20/11/2021,15,16277,0,1010,15,17287,FALSE
North West,21/11/2021,6,16283,1,1011,7,17294,FALSE
North West,22/11/2021,10,16293,1,1012,11,17305,FALSE
North West,23/11/2021,12,16305,2,1014,14,17319,FALSE
North West,24/11/2021,5,16310,2,1016,7,17326,FALSE
North West,25/11/2021,18,16328,0,1016,18,17344,FALSE
North West,26/11/2021,12,16340,1,1017,13,17357,FALSE
North West,27/11/2021,11,16351,2,1019,13,17370,FALSE
North West,28/11/2021,16,16367,2,1021,18,17388,FALSE
North West,29/11/2021,16,16383,0,1021,16,17404,FALSE
North West,30/11/2021,10,16393,2,1023,12,17416,FALSE
North West,01/12/2021,11,16404,1,1024,12,17428,FALSE
North West,02/12/2021,10,16414,1,1025,11,17439,FALSE
North West,03/12/2021,11,16425,0,1025,11,17450,FALSE
North West,04/12/2021,16,16441,1,1026,17,17467,FALSE
North West,05/12/2021,11,16452,4,1030,15,17482,FALSE
North West,06/12/2021,8,16460,1,1031,9,17491,FALSE
North West,07/12/2021,13,16473,1,1032,14,17505,FALSE
North West,08/12/2021,19,16492,2,1034,21,17526,FALSE
North West,09/12/2021,10,16502,3,1037,13,17539,FALSE
North West,10/12/2021,9,16511,1,1038,10,17549,FALSE
North West,11/12/2021,12,16523,0,1038,12,17561,FALSE
North West,12/12/2021,16,16539,1,1039,17,17578,FALSE
North West,13/12/2021,10,16549,2,1041,12,17590,FALSE
North West,14/12/2021,12,16561,1,1042,13,17603,FALSE
North West,15/12/2021,16,16577,2,1044,18,17621,FALSE
North West,16/12/2021,13,16590,1,1045,14,17635,FALSE
North West,17/12/2021,12,16602,1,1046,13,17648,FALSE
North West,18/12/2021,11,16613,0,1046,11,17659,FALSE
North West,19/12/2021,16,16629,1,1047,17,17676,FALSE
North West,20/12/2021,17,16646,0,1047,17,17693,FALSE
North West,21/12/2021,12,16658,0,1047,12,17705,FALSE
North West,22/12/2021,13,16671,1,1048,14,17719,FALSE
North West,23/12/2021,17,16688,1,1049,18,17737,FALSE
North West,24/12/2021,14,16702,0,1049,14,17751,FALSE
North West,25/12/2021,11,16713,1,1050,12,17763,FALSE
North West,26/12/2021,11,16724,2,1052,13,17776,FALSE
North West,27/12/2021,14,16738,3,1055,17,17793,FALSE
North West,28/12/2021,16,16754,2,1057,18,17811,FALSE
North West,29/12/2021,11,16765,0,1057,11,17822,FALSE
North West,30/12/2021,23,16788,1,1058,24,17846,FALSE
North West,31/12/2021,25,16813,1,1059,26,17872,FALSE
North West,01/01/2022,23,16836,3,1062,26,17898,FALSE
North West,02/01/2022,16,16852,1,1063,17,17915,FALSE
North West,03/01/2022,20,16872,2,1065,22,17937,FALSE
North West,04/01/2022,29,16901,1,1066,30,17967,FALSE
North West,05/01/2022,30,16931,0,1066,30,17997,FALSE
North West,06/01/2022,28,16959,1,1067,29,18026,FALSE
North West,07/01/2022,34,16993,2,1069,36,18062,FALSE
North West,08/01/2022,31,17024,3,1072,34,18096,FALSE
North West,09/01/2022,35,17059,1,1073,36,18132,FALSE
North West,10/01/2022,30,17089,1,1074,31,18163,FALSE
North West,11/01/2022,30,17119,5,1079,35,18198,FALSE
North West,12/01/2022,23,17142,0,1079,23,18221,FALSE
North West,13/01/2022,31,17173,2,1081,33,18254,FALSE
North West,14/01/2022,27,17200,4,1085,31,18285,FALSE
North West,15/01/2022,30,17230,4,1089,34,18319,FALSE
North West,16/01/2022,33,17263,2,1091,35,18354,FALSE
North West,17/01/2022,31,17294,0,1091,31,18385,FALSE
North West,18/01/2022,31,17325,1,1092,32,18417,FALSE
North West,19/01/2022,27,17352,1,1093,28,18445,FALSE
North West,20/01/2022,26,17378,0,1093,26,18471,FALSE
North West,21/01/2022,28,17406,1,1094,29,18500,FALSE
North West,22/01/2022,32,17438,0,1094,32,18532,FALSE
North West,23/01/2022,26,17464,1,1095,27,18559,FALSE
North West,24/01/2022,34,17498,1,1096,35,18594,FALSE
North West,25/01/2022,23,17521,0,1096,23,18617,FALSE
North West,26/01/2022,19,17540,1,1097,20,18637,FALSE
North West,27/01/2022,23,17563,2,1099,25,18662,FALSE
North West,28/01/2022,22,17585,1,1100,23,18685,FALSE
North West,29/01/2022,28,17613,1,1101,29,18714,FALSE
North West,30/01/2022,18,17631,3,1104,21,18735,FALSE
North West,31/01/2022,25,17656,0,1104,25,18760,FALSE
North West,01/02/2022,29,17685,1,1105,30,18790,FALSE
North West,02/02/2022,18,17703,0,1105,18,18808,TRUE
North West,03/02/2022,24,17727,1,1106,25,18833,TRUE
North West,04/02/2022,6,17733,1,1107,7,18840,TRUE
North West,05/02/2022,0,17733,0,1107,0,18840,TRUE
North West,06/02/2022,2,17735,0,1107,2,18842,TRUE
