nhs_england_region,date,new_deaths_with_positive_test,cumulative_deaths_with_positive_test,new_deaths_without_positive_test,cumulative_deaths_without_positive_test,new_deaths_total,cumulative_deaths_total,data_subject_to_change
South West,29/02/2020,0,0,0,0,0,0,FALSE
South West,01/03/2020,0,0,0,0,0,0,FALSE
South West,02/03/2020,0,0,0,0,0,0,FALSE
South West,03/03/2020,0,0,0,0,0,0,FALSE
South West,04/03/2020,0,0,0,0,0,0,FALSE
South West,05/03/2020,0,0,0,0,0,0,FALSE
South West,06/03/2020,0,0,0,0,0,0,FALSE
South West,07/03/2020,0,0,0,0,0,0,FALSE
South West,08/03/2020,0,0,0,0,0,0,FALSE
South West,09/03/2020,0,0,0,0,0,0,FALSE
South West,10/03/2020,0,0,0,0,0,0,FALSE
South West,11/03/2020,1,1,0,0,1,1,FALSE
South West,12/03/2020,0,1,0,0,0,1,FALSE
South West,13/03/2020,0,1,0,0,0,1,FALSE
South West,14/03/2020,1,2,0,0,1,2,FALSE
South West,15/03/2020,0,2,0,0,0,2,FALSE
South West,16/03/2020,0,2,0,0,0,2,FALSE
South West,17/03/2020,2,4,0,0,2,4,FALSE
South West,18/03/2020,2,6,0,0,2,6,FALSE
South West,19/03/2020,4,10,0,0,4,10,FALSE
South West,20/03/2020,3,13,0,0,3,13,FALSE
South West,21/03/2020,7,20,0,0,7,20,FALSE
South West,22/03/2020,7,27,0,0,7,27,FALSE
South West,23/03/2020,8,35,0,0,8,35,FALSE
South West,24/03/2020,7,42,0,0,7,42,FALSE
South West,25/03/2020,9,51,0,0,9,51,FALSE
South West,26/03/2020,11,62,0,0,11,62,FALSE
South West,27/03/2020,13,75,0,0,13,75,FALSE
South West,28/03/2020,21,96,0,0,21,96,FALSE
South West,29/03/2020,18,114,0,0,18,114,FALSE
South West,30/03/2020,23,137,0,0,23,137,FALSE
South West,31/03/2020,23,160,0,0,23,160,FALSE
South West,01/04/2020,21,181,0,0,21,181,FALSE
South West,02/04/2020,23,204,0,0,23,204,FALSE
South West,03/04/2020,31,235,0,0,31,235,FALSE
South West,04/04/2020,42,277,0,0,42,277,FALSE
South West,05/04/2020,32,309,0,0,32,309,FALSE
South West,06/04/2020,35,344,0,0,35,344,FALSE
South West,07/04/2020,39,383,0,0,39,383,FALSE
South West,08/04/2020,47,430,0,0,47,430,FALSE
South West,09/04/2020,24,454,0,0,24,454,FALSE
South West,10/04/2020,46,500,0,0,46,500,FALSE
South West,11/04/2020,43,543,0,0,43,543,FALSE
South West,12/04/2020,23,566,0,0,23,566,FALSE
South West,13/04/2020,28,594,0,0,28,594,FALSE
South West,14/04/2020,24,618,0,0,24,618,FALSE
South West,15/04/2020,32,650,0,0,32,650,FALSE
South West,16/04/2020,29,679,0,0,29,679,FALSE
South West,17/04/2020,33,712,0,0,33,712,FALSE
South West,18/04/2020,25,737,0,0,25,737,FALSE
South West,19/04/2020,31,768,0,0,31,768,FALSE
South West,20/04/2020,26,794,0,0,26,794,FALSE
South West,21/04/2020,26,820,0,0,26,820,FALSE
South West,22/04/2020,23,843,0,0,23,843,FALSE
South West,23/04/2020,17,860,0,0,17,860,FALSE
South West,24/04/2020,19,879,2,2,21,881,FALSE
South West,25/04/2020,15,894,1,3,16,897,FALSE
South West,26/04/2020,27,921,0,3,27,924,FALSE
South West,27/04/2020,13,934,4,7,17,941,FALSE
South West,28/04/2020,17,951,1,8,18,959,FALSE
South West,29/04/2020,15,966,0,8,15,974,FALSE
South West,30/04/2020,26,992,2,10,28,1002,FALSE
South West,01/05/2020,6,998,1,11,7,1009,FALSE
South West,02/05/2020,7,1005,0,11,7,1016,FALSE
South West,03/05/2020,10,1015,3,14,13,1029,FALSE
South West,04/05/2020,17,1032,4,18,21,1050,FALSE
South West,05/05/2020,14,1046,5,23,19,1069,FALSE
South West,06/05/2020,19,1065,1,24,20,1089,FALSE
South West,07/05/2020,16,1081,1,25,17,1106,FALSE
South West,08/05/2020,6,1087,2,27,8,1114,FALSE
South West,09/05/2020,11,1098,3,30,14,1128,FALSE
South West,10/05/2020,5,1103,3,33,8,1136,FALSE
South West,11/05/2020,8,1111,2,35,10,1146,FALSE
South West,12/05/2020,7,1118,0,35,7,1153,FALSE
South West,13/05/2020,7,1125,1,36,8,1161,FALSE
South West,14/05/2020,6,1131,2,38,8,1169,FALSE
South West,15/05/2020,4,1135,2,40,6,1175,FALSE
South West,16/05/2020,4,1139,1,41,5,1180,FALSE
South West,17/05/2020,6,1145,4,45,10,1190,FALSE
South West,18/05/2020,4,1149,0,45,4,1194,FALSE
South West,19/05/2020,6,1155,2,47,8,1202,FALSE
South West,20/05/2020,1,1156,1,48,2,1204,FALSE
South West,21/05/2020,9,1165,4,52,13,1217,FALSE
South West,22/05/2020,7,1172,3,55,10,1227,FALSE
South West,23/05/2020,6,1178,1,56,7,1234,FALSE
South West,24/05/2020,3,1181,3,59,6,1240,FALSE
South West,25/05/2020,8,1189,0,59,8,1248,FALSE
South West,26/05/2020,11,1200,0,59,11,1259,FALSE
South West,27/05/2020,5,1205,2,61,7,1266,FALSE
South West,28/05/2020,10,1215,0,61,10,1276,FALSE
South West,29/05/2020,7,1222,0,61,7,1283,FALSE
South West,30/05/2020,3,1225,0,61,3,1286,FALSE
South West,31/05/2020,2,1227,3,64,5,1291,FALSE
South West,01/06/2020,7,1234,1,65,8,1299,FALSE
South West,02/06/2020,2,1236,0,65,2,1301,FALSE
South West,03/06/2020,7,1243,4,69,11,1312,FALSE
South West,04/06/2020,2,1245,1,70,3,1315,FALSE
South West,05/06/2020,2,1247,1,71,3,1318,FALSE
South West,06/06/2020,1,1248,0,71,1,1319,FALSE
South West,07/06/2020,3,1251,0,71,3,1322,FALSE
South West,08/06/2020,3,1254,1,72,4,1326,FALSE
South West,09/06/2020,0,1254,0,72,0,1326,FALSE
South West,10/06/2020,1,1255,0,72,1,1327,FALSE
South West,11/06/2020,2,1257,1,73,3,1330,FALSE
South West,12/06/2020,2,1259,1,74,3,1333,FALSE
South West,13/06/2020,2,1261,1,75,3,1336,FALSE
South West,14/06/2020,0,1261,0,75,0,1336,FALSE
South West,15/06/2020,2,1263,0,75,2,1338,FALSE
South West,16/06/2020,2,1265,3,78,5,1343,FALSE
South West,17/06/2020,0,1265,0,78,0,1343,FALSE
South West,18/06/2020,0,1265,0,78,0,1343,FALSE
South West,19/06/2020,0,1265,1,79,1,1344,FALSE
South West,20/06/2020,2,1267,0,79,2,1346,FALSE
South West,21/06/2020,0,1267,0,79,0,1346,FALSE
South West,22/06/2020,1,1268,0,79,1,1347,FALSE
South West,23/06/2020,1,1269,0,79,1,1348,FALSE
South West,24/06/2020,1,1270,0,79,1,1349,FALSE
South West,25/06/2020,0,1270,0,79,0,1349,FALSE
South West,26/06/2020,3,1273,0,79,3,1352,FALSE
South West,27/06/2020,0,1273,0,79,0,1352,FALSE
South West,28/06/2020,0,1273,0,79,0,1352,FALSE
South West,29/06/2020,1,1274,0,79,1,1353,FALSE
South West,30/06/2020,0,1274,1,80,1,1354,FALSE
South West,01/07/2020,0,1274,0,80,0,1354,FALSE
South West,02/07/2020,0,1274,0,80,0,1354,FALSE
South West,03/07/2020,0,1274,0,80,0,1354,FALSE
South West,04/07/2020,0,1274,1,81,1,1355,FALSE
South West,05/07/2020,1,1275,0,81,1,1356,FALSE
South West,06/07/2020,0,1275,1,82,1,1357,FALSE
South West,07/07/2020,0,1275,1,83,1,1358,FALSE
South West,08/07/2020,2,1277,0,83,2,1360,FALSE
South West,09/07/2020,0,1277,0,83,0,1360,FALSE
South West,10/07/2020,1,1278,0,83,1,1361,FALSE
South West,11/07/2020,0,1278,0,83,0,1361,FALSE
South West,12/07/2020,0,1278,0,83,0,1361,FALSE
South West,13/07/2020,1,1279,0,83,1,1362,FALSE
South West,14/07/2020,0,1279,0,83,0,1362,FALSE
South West,15/07/2020,0,1279,0,83,0,1362,FALSE
South West,16/07/2020,0,1279,1,84,1,1363,FALSE
South West,17/07/2020,1,1280,0,84,1,1364,FALSE
South West,18/07/2020,0,1280,0,84,0,1364,FALSE
South West,19/07/2020,0,1280,0,84,0,1364,FALSE
South West,20/07/2020,0,1280,1,85,1,1365,FALSE
South West,21/07/2020,0,1280,0,85,0,1365,FALSE
South West,22/07/2020,0,1280,0,85,0,1365,FALSE
South West,23/07/2020,0,1280,0,85,0,1365,FALSE
South West,24/07/2020,0,1280,0,85,0,1365,FALSE
South West,25/07/2020,0,1280,0,85,0,1365,FALSE
South West,26/07/2020,0,1280,0,85,0,1365,FALSE
South West,27/07/2020,0,1280,0,85,0,1365,FALSE
South West,28/07/2020,0,1280,0,85,0,1365,FALSE
South West,29/07/2020,0,1280,0,85,0,1365,FALSE
South West,30/07/2020,1,1281,0,85,1,1366,FALSE
South West,31/07/2020,0,1281,0,85,0,1366,FALSE
South West,01/08/2020,0,1281,0,85,0,1366,FALSE
South West,02/08/2020,0,1281,0,85,0,1366,FALSE
South West,03/08/2020,0,1281,0,85,0,1366,FALSE
South West,04/08/2020,0,1281,0,85,0,1366,FALSE
South West,05/08/2020,0,1281,0,85,0,1366,FALSE
South West,06/08/2020,0,1281,0,85,0,1366,FALSE
South West,07/08/2020,0,1281,0,85,0,1366,FALSE
South West,08/08/2020,0,1281,0,85,0,1366,FALSE
South West,09/08/2020,0,1281,0,85,0,1366,FALSE
South West,10/08/2020,0,1281,0,85,0,1366,FALSE
South West,11/08/2020,0,1281,0,85,0,1366,FALSE
South West,12/08/2020,0,1281,0,85,0,1366,FALSE
South West,13/08/2020,0,1281,0,85,0,1366,FALSE
South West,14/08/2020,1,1282,0,85,1,1367,FALSE
South West,15/08/2020,0,1282,0,85,0,1367,FALSE
South West,16/08/2020,0,1282,0,85,0,1367,FALSE
South West,17/08/2020,2,1284,0,85,2,1369,FALSE
South West,18/08/2020,0,1284,0,85,0,1369,FALSE
South West,19/08/2020,0,1284,0,85,0,1369,FALSE
South West,20/08/2020,0,1284,1,86,1,1370,FALSE
South West,21/08/2020,0,1284,0,86,0,1370,FALSE
South West,22/08/2020,0,1284,0,86,0,1370,FALSE
South West,23/08/2020,0,1284,0,86,0,1370,FALSE
South West,24/08/2020,0,1284,0,86,0,1370,FALSE
South West,25/08/2020,1,1285,0,86,1,1371,FALSE
South West,26/08/2020,0,1285,0,86,0,1371,FALSE
South West,27/08/2020,1,1286,0,86,1,1372,FALSE
South West,28/08/2020,0,1286,1,87,1,1373,FALSE
South West,29/08/2020,0,1286,0,87,0,1373,FALSE
South West,30/08/2020,0,1286,0,87,0,1373,FALSE
South West,31/08/2020,0,1286,0,87,0,1373,FALSE
South West,01/09/2020,0,1286,0,87,0,1373,FALSE
South West,02/09/2020,0,1286,0,87,0,1373,FALSE
South West,03/09/2020,0,1286,1,88,1,1374,FALSE
South West,04/09/2020,0,1286,0,88,0,1374,FALSE
South West,05/09/2020,0,1286,0,88,0,1374,FALSE
South West,06/09/2020,0,1286,0,88,0,1374,FALSE
South West,07/09/2020,0,1286,0,88,0,1374,FALSE
South West,08/09/2020,1,1287,0,88,1,1375,FALSE
South West,09/09/2020,0,1287,0,88,0,1375,FALSE
South West,10/09/2020,0,1287,0,88,0,1375,FALSE
South West,11/09/2020,0,1287,0,88,0,1375,FALSE
South West,12/09/2020,0,1287,0,88,0,1375,FALSE
South West,13/09/2020,1,1288,0,88,1,1376,FALSE
South West,14/09/2020,0,1288,0,88,0,1376,FALSE
South West,15/09/2020,0,1288,1,89,1,1377,FALSE
South West,16/09/2020,0,1288,0,89,0,1377,FALSE
South West,17/09/2020,1,1289,0,89,1,1378,FALSE
South West,18/09/2020,0,1289,1,90,1,1379,FALSE
South West,19/09/2020,0,1289,0,90,0,1379,FALSE
South West,20/09/2020,1,1290,0,90,1,1380,FALSE
South West,21/09/2020,0,1290,0,90,0,1380,FALSE
South West,22/09/2020,0,1290,0,90,0,1380,FALSE
South West,23/09/2020,0,1290,0,90,0,1380,FALSE
South West,24/09/2020,1,1291,1,91,2,1382,FALSE
South West,25/09/2020,0,1291,0,91,0,1382,FALSE
South West,26/09/2020,0,1291,0,91,0,1382,FALSE
South West,27/09/2020,0,1291,0,91,0,1382,FALSE
South West,28/09/2020,0,1291,0,91,0,1382,FALSE
South West,29/09/2020,0,1291,0,91,0,1382,FALSE
South West,30/09/2020,0,1291,0,91,0,1382,FALSE
South West,01/10/2020,0,1291,0,91,0,1382,FALSE
South West,02/10/2020,1,1292,0,91,1,1383,FALSE
South West,03/10/2020,0,1292,0,91,0,1383,FALSE
South West,04/10/2020,0,1292,0,91,0,1383,FALSE
South West,05/10/2020,0,1292,0,91,0,1383,FALSE
South West,06/10/2020,1,1293,0,91,1,1384,FALSE
South West,07/10/2020,0,1293,0,91,0,1384,FALSE
South West,08/10/2020,1,1294,0,91,1,1385,FALSE
South West,09/10/2020,1,1295,0,91,1,1386,FALSE
South West,10/10/2020,0,1295,0,91,0,1386,FALSE
South West,11/10/2020,4,1299,0,91,4,1390,FALSE
South West,12/10/2020,2,1301,0,91,2,1392,FALSE
South West,13/10/2020,0,1301,0,91,0,1392,FALSE
South West,14/10/2020,3,1304,0,91,3,1395,FALSE
South West,15/10/2020,1,1305,0,91,1,1396,FALSE
South West,16/10/2020,2,1307,0,91,2,1398,FALSE
South West,17/10/2020,8,1315,0,91,8,1406,FALSE
South West,18/10/2020,2,1317,0,91,2,1408,FALSE
South West,19/10/2020,2,1319,0,91,2,1410,FALSE
South West,20/10/2020,3,1322,0,91,3,1413,FALSE
South West,21/10/2020,6,1328,0,91,6,1419,FALSE
South West,22/10/2020,6,1334,0,91,6,1425,FALSE
South West,23/10/2020,5,1339,0,91,5,1430,FALSE
South West,24/10/2020,5,1344,0,91,5,1435,FALSE
South West,25/10/2020,5,1349,0,91,5,1440,FALSE
South West,26/10/2020,7,1356,0,91,7,1447,FALSE
South West,27/10/2020,6,1362,0,91,6,1453,FALSE
South West,28/10/2020,8,1370,0,91,8,1461,FALSE
South West,29/10/2020,11,1381,0,91,11,1472,FALSE
South West,30/10/2020,8,1389,1,92,9,1481,FALSE
South West,31/10/2020,5,1394,1,93,6,1487,FALSE
South West,01/11/2020,5,1399,0,93,5,1492,FALSE
South West,02/11/2020,11,1410,0,93,11,1503,FALSE
South West,03/11/2020,7,1417,2,95,9,1512,FALSE
South West,04/11/2020,8,1425,1,96,9,1521,FALSE
South West,05/11/2020,5,1430,1,97,6,1527,FALSE
South West,06/11/2020,11,1441,0,97,11,1538,FALSE
South West,07/11/2020,10,1451,0,97,10,1548,FALSE
South West,08/11/2020,10,1461,0,97,10,1558,FALSE
South West,09/11/2020,12,1473,0,97,12,1570,FALSE
South West,10/11/2020,6,1479,0,97,6,1576,FALSE
South West,11/11/2020,13,1492,0,97,13,1589,FALSE
South West,12/11/2020,17,1509,0,97,17,1606,FALSE
South West,13/11/2020,9,1518,1,98,10,1616,FALSE
South West,14/11/2020,8,1526,0,98,8,1624,FALSE
South West,15/11/2020,16,1542,3,101,19,1643,FALSE
South West,16/11/2020,19,1561,0,101,19,1662,FALSE
South West,17/11/2020,17,1578,0,101,17,1679,FALSE
South West,18/11/2020,26,1604,0,101,26,1705,FALSE
South West,19/11/2020,15,1619,0,101,15,1720,FALSE
South West,20/11/2020,25,1644,1,102,26,1746,FALSE
South West,21/11/2020,25,1669,0,102,25,1771,FALSE
South West,22/11/2020,24,1693,2,104,26,1797,FALSE
South West,23/11/2020,14,1707,1,105,15,1812,FALSE
South West,24/11/2020,20,1727,0,105,20,1832,FALSE
South West,25/11/2020,25,1752,0,105,25,1857,FALSE
South West,26/11/2020,16,1768,0,105,16,1873,FALSE
South West,27/11/2020,21,1789,1,106,22,1895,FALSE
South West,28/11/2020,35,1824,1,107,36,1931,FALSE
South West,29/11/2020,15,1839,2,109,17,1948,FALSE
South West,30/11/2020,22,1861,1,110,23,1971,FALSE
South West,01/12/2020,19,1880,0,110,19,1990,FALSE
South West,02/12/2020,15,1895,2,112,17,2007,FALSE
South West,03/12/2020,14,1909,1,113,15,2022,FALSE
South West,04/12/2020,20,1929,1,114,21,2043,FALSE
South West,05/12/2020,17,1946,0,114,17,2060,FALSE
South West,06/12/2020,13,1959,1,115,14,2074,FALSE
South West,07/12/2020,16,1975,0,115,16,2090,FALSE
South West,08/12/2020,19,1994,0,115,19,2109,FALSE
South West,09/12/2020,22,2016,0,115,22,2131,FALSE
South West,10/12/2020,21,2037,2,117,23,2154,FALSE
South West,11/12/2020,20,2057,1,118,21,2175,FALSE
South West,12/12/2020,15,2072,5,123,20,2195,FALSE
South West,13/12/2020,19,2091,1,124,20,2215,FALSE
South West,14/12/2020,20,2111,1,125,21,2236,FALSE
South West,15/12/2020,20,2131,0,125,20,2256,FALSE
South West,16/12/2020,9,2140,1,126,10,2266,FALSE
South West,17/12/2020,26,2166,0,126,26,2292,FALSE
South West,18/12/2020,11,2177,2,128,13,2305,FALSE
South West,19/12/2020,22,2199,0,128,22,2327,FALSE
South West,20/12/2020,19,2218,0,128,19,2346,FALSE
South West,21/12/2020,22,2240,0,128,22,2368,FALSE
South West,22/12/2020,11,2251,3,131,14,2382,FALSE
South West,23/12/2020,16,2267,5,136,21,2403,FALSE
South West,24/12/2020,18,2285,0,136,18,2421,FALSE
South West,25/12/2020,19,2304,1,137,20,2441,FALSE
South West,26/12/2020,24,2328,2,139,26,2467,FALSE
South West,27/12/2020,24,2352,0,139,24,2491,FALSE
South West,28/12/2020,21,2373,1,140,22,2513,FALSE
South West,29/12/2020,20,2393,1,141,21,2534,FALSE
South West,30/12/2020,17,2410,0,141,17,2551,FALSE
South West,31/12/2020,28,2438,1,142,29,2580,FALSE
South West,01/01/2021,29,2467,4,146,33,2613,FALSE
South West,02/01/2021,25,2492,1,147,26,2639,FALSE
South West,03/01/2021,28,2520,1,148,29,2668,FALSE
South West,04/01/2021,33,2553,0,148,33,2701,FALSE
South West,05/01/2021,31,2584,1,149,32,2733,FALSE
South West,06/01/2021,27,2611,1,150,28,2761,FALSE
South West,07/01/2021,31,2642,5,155,36,2797,FALSE
South West,08/01/2021,34,2676,0,155,34,2831,FALSE
South West,09/01/2021,26,2702,2,157,28,2859,FALSE
South West,10/01/2021,34,2736,2,159,36,2895,FALSE
South West,11/01/2021,40,2776,0,159,40,2935,FALSE
South West,12/01/2021,53,2829,3,162,56,2991,FALSE
South West,13/01/2021,43,2872,1,163,44,3035,FALSE
South West,14/01/2021,39,2911,0,163,39,3074,FALSE
South West,15/01/2021,47,2958,4,167,51,3125,FALSE
South West,16/01/2021,57,3015,1,168,58,3183,FALSE
South West,17/01/2021,44,3059,2,170,46,3229,FALSE
South West,18/01/2021,47,3106,1,171,48,3277,FALSE
South West,19/01/2021,46,3152,2,173,48,3325,FALSE
South West,20/01/2021,65,3217,1,174,66,3391,FALSE
South West,21/01/2021,63,3280,2,176,65,3456,FALSE
South West,22/01/2021,62,3342,2,178,64,3520,FALSE
South West,23/01/2021,54,3396,1,179,55,3575,FALSE
South West,24/01/2021,59,3455,1,180,60,3635,FALSE
South West,25/01/2021,62,3517,2,182,64,3699,FALSE
South West,26/01/2021,47,3564,0,182,47,3746,FALSE
South West,27/01/2021,47,3611,4,186,51,3797,FALSE
South West,28/01/2021,53,3664,1,187,54,3851,FALSE
South West,29/01/2021,42,3706,1,188,43,3894,FALSE
South West,30/01/2021,39,3745,1,189,40,3934,FALSE
South West,31/01/2021,36,3781,1,190,37,3971,FALSE
South West,01/02/2021,29,3810,1,191,30,4001,FALSE
South West,02/02/2021,38,3848,1,192,39,4040,FALSE
South West,03/02/2021,32,3880,1,193,33,4073,FALSE
South West,04/02/2021,34,3914,1,194,35,4108,FALSE
South West,05/02/2021,25,3939,4,198,29,4137,FALSE
South West,06/02/2021,39,3978,2,200,41,4178,FALSE
South West,07/02/2021,36,4014,2,202,38,4216,FALSE
South West,08/02/2021,32,4046,2,204,34,4250,FALSE
South West,09/02/2021,32,4078,1,205,33,4283,FALSE
South West,10/02/2021,19,4097,1,206,20,4303,FALSE
South West,11/02/2021,20,4117,2,208,22,4325,FALSE
South West,12/02/2021,29,4146,4,212,33,4358,FALSE
South West,13/02/2021,30,4176,0,212,30,4388,FALSE
South West,14/02/2021,18,4194,4,216,22,4410,FALSE
South West,15/02/2021,22,4216,2,218,24,4434,FALSE
South West,16/02/2021,12,4228,1,219,13,4447,FALSE
South West,17/02/2021,20,4248,1,220,21,4468,FALSE
South West,18/02/2021,21,4269,2,222,23,4491,FALSE
South West,19/02/2021,19,4288,3,225,22,4513,FALSE
South West,20/02/2021,14,4302,3,228,17,4530,FALSE
South West,21/02/2021,17,4319,2,230,19,4549,FALSE
South West,22/02/2021,12,4331,1,231,13,4562,FALSE
South West,23/02/2021,6,4337,4,235,10,4572,FALSE
South West,24/02/2021,11,4348,5,240,16,4588,FALSE
South West,25/02/2021,13,4361,1,241,14,4602,FALSE
South West,26/02/2021,7,4368,1,242,8,4610,FALSE
South West,27/02/2021,7,4375,3,245,10,4620,FALSE
South West,28/02/2021,11,4386,3,248,14,4634,FALSE
South West,01/03/2021,15,4401,0,248,15,4649,FALSE
South West,02/03/2021,8,4409,0,248,8,4657,FALSE
South West,03/03/2021,3,4412,1,249,4,4661,FALSE
South West,04/03/2021,5,4417,2,251,7,4668,FALSE
South West,05/03/2021,4,4421,0,251,4,4672,FALSE
South West,06/03/2021,7,4428,2,253,9,4681,FALSE
South West,07/03/2021,1,4429,1,254,2,4683,FALSE
South West,08/03/2021,9,4438,2,256,11,4694,FALSE
South West,09/03/2021,4,4442,3,259,7,4701,FALSE
South West,10/03/2021,4,4446,2,261,6,4707,FALSE
South West,11/03/2021,3,4449,1,262,4,4711,FALSE
South West,12/03/2021,3,4452,0,262,3,4714,FALSE
South West,13/03/2021,5,4457,1,263,6,4720,FALSE
South West,14/03/2021,2,4459,2,265,4,4724,FALSE
South West,15/03/2021,3,4462,0,265,3,4727,FALSE
South West,16/03/2021,2,4464,1,266,3,4730,FALSE
South West,17/03/2021,4,4468,0,266,4,4734,FALSE
South West,18/03/2021,1,4469,0,266,1,4735,FALSE
South West,19/03/2021,3,4472,0,266,3,4738,FALSE
South West,20/03/2021,1,4473,0,266,1,4739,FALSE
South West,21/03/2021,4,4477,1,267,5,4744,FALSE
South West,22/03/2021,2,4479,0,267,2,4746,FALSE
South West,23/03/2021,2,4481,1,268,3,4749,FALSE
South West,24/03/2021,1,4482,0,268,1,4750,FALSE
South West,25/03/2021,2,4484,1,269,3,4753,FALSE
South West,26/03/2021,1,4485,1,270,2,4755,FALSE
South West,27/03/2021,1,4486,0,270,1,4756,FALSE
South West,28/03/2021,1,4487,0,270,1,4757,FALSE
South West,29/03/2021,0,4487,1,271,1,4758,FALSE
South West,30/03/2021,0,4487,1,272,1,4759,FALSE
South West,31/03/2021,2,4489,0,272,2,4761,FALSE
South West,01/04/2021,1,4490,0,272,1,4762,FALSE
South West,02/04/2021,0,4490,0,272,0,4762,FALSE
South West,03/04/2021,2,4492,0,272,2,4764,FALSE
South West,04/04/2021,1,4493,0,272,1,4765,FALSE
South West,05/04/2021,2,4495,2,274,4,4769,FALSE
South West,06/04/2021,0,4495,0,274,0,4769,FALSE
South West,07/04/2021,3,4498,1,275,4,4773,FALSE
South West,08/04/2021,2,4500,0,275,2,4775,FALSE
South West,09/04/2021,1,4501,1,276,2,4777,FALSE
South West,10/04/2021,1,4502,0,276,1,4778,FALSE
South West,11/04/2021,1,4503,1,277,2,4780,FALSE
South West,12/04/2021,2,4505,0,277,2,4782,FALSE
South West,13/04/2021,0,4505,1,278,1,4783,FALSE
South West,14/04/2021,0,4505,0,278,0,4783,FALSE
South West,15/04/2021,0,4505,0,278,0,4783,FALSE
South West,16/04/2021,0,4505,0,278,0,4783,FALSE
South West,17/04/2021,2,4507,0,278,2,4785,FALSE
South West,18/04/2021,1,4508,0,278,1,4786,FALSE
South West,19/04/2021,0,4508,0,278,0,4786,FALSE
South West,20/04/2021,2,4510,0,278,2,4788,FALSE
South West,21/04/2021,3,4513,0,278,3,4791,FALSE
South West,22/04/2021,4,4517,0,278,4,4795,FALSE
South West,23/04/2021,1,4518,0,278,1,4796,FALSE
South West,24/04/2021,0,4518,0,278,0,4796,FALSE
South West,25/04/2021,0,4518,0,278,0,4796,FALSE
South West,26/04/2021,1,4519,0,278,1,4797,FALSE
South West,27/04/2021,1,4520,0,278,1,4798,FALSE
South West,28/04/2021,2,4522,0,278,2,4800,FALSE
South West,29/04/2021,1,4523,0,278,1,4801,FALSE
South West,30/04/2021,2,4525,0,278,2,4803,FALSE
South West,01/05/2021,0,4525,0,278,0,4803,FALSE
South West,02/05/2021,2,4527,0,278,2,4805,FALSE
South West,03/05/2021,1,4528,0,278,1,4806,FALSE
South West,04/05/2021,2,4530,0,278,2,4808,FALSE
South West,05/05/2021,0,4530,0,278,0,4808,FALSE
South West,06/05/2021,0,4530,0,278,0,4808,FALSE
South West,07/05/2021,1,4531,0,278,1,4809,FALSE
South West,08/05/2021,1,4532,0,278,1,4810,FALSE
South West,09/05/2021,1,4533,0,278,1,4811,FALSE
South West,10/05/2021,0,4533,0,278,0,4811,FALSE
South West,11/05/2021,0,4533,0,278,0,4811,FALSE
South West,12/05/2021,0,4533,0,278,0,4811,FALSE
South West,13/05/2021,0,4533,0,278,0,4811,FALSE
South West,14/05/2021,0,4533,0,278,0,4811,FALSE
South West,15/05/2021,0,4533,1,279,1,4812,FALSE
South West,16/05/2021,0,4533,0,279,0,4812,FALSE
South West,17/05/2021,0,4533,0,279,0,4812,FALSE
South West,18/05/2021,0,4533,0,279,0,4812,FALSE
South West,19/05/2021,1,4534,0,279,1,4813,FALSE
South West,20/05/2021,0,4534,0,279,0,4813,FALSE
South West,21/05/2021,0,4534,1,280,1,4814,FALSE
South West,22/05/2021,0,4534,0,280,0,4814,FALSE
South West,23/05/2021,0,4534,0,280,0,4814,FALSE
South West,24/05/2021,0,4534,0,280,0,4814,FALSE
South West,25/05/2021,0,4534,0,280,0,4814,FALSE
South West,26/05/2021,0,4534,0,280,0,4814,FALSE
South West,27/05/2021,0,4534,0,280,0,4814,FALSE
South West,28/05/2021,0,4534,0,280,0,4814,FALSE
South West,29/05/2021,0,4534,0,280,0,4814,FALSE
South West,30/05/2021,0,4534,1,281,1,4815,FALSE
South West,31/05/2021,0,4534,0,281,0,4815,FALSE
South West,01/06/2021,0,4534,0,281,0,4815,FALSE
South West,02/06/2021,0,4534,0,281,0,4815,FALSE
South West,03/06/2021,0,4534,0,281,0,4815,FALSE
South West,04/06/2021,0,4534,0,281,0,4815,FALSE
South West,05/06/2021,0,4534,0,281,0,4815,FALSE
South West,06/06/2021,0,4534,0,281,0,4815,FALSE
South West,07/06/2021,0,4534,0,281,0,4815,FALSE
South West,08/06/2021,0,4534,0,281,0,4815,FALSE
South West,09/06/2021,0,4534,0,281,0,4815,FALSE
South West,10/06/2021,1,4535,0,281,1,4816,FALSE
South West,11/06/2021,0,4535,0,281,0,4816,FALSE
South West,12/06/2021,0,4535,0,281,0,4816,FALSE
South West,13/06/2021,0,4535,0,281,0,4816,FALSE
South West,14/06/2021,0,4535,0,281,0,4816,FALSE
South West,15/06/2021,0,4535,0,281,0,4816,FALSE
South West,16/06/2021,0,4535,0,281,0,4816,FALSE
South West,17/06/2021,0,4535,0,281,0,4816,FALSE
South West,18/06/2021,0,4535,0,281,0,4816,FALSE
South West,19/06/2021,0,4535,0,281,0,4816,FALSE
South West,20/06/2021,1,4536,0,281,1,4817,FALSE
South West,21/06/2021,0,4536,0,281,0,4817,FALSE
South West,22/06/2021,0,4536,0,281,0,4817,FALSE
South West,23/06/2021,0,4536,0,281,0,4817,FALSE
South West,24/06/2021,0,4536,0,281,0,4817,FALSE
South West,25/06/2021,1,4537,1,282,2,4819,FALSE
South West,26/06/2021,0,4537,0,282,0,4819,FALSE
South West,27/06/2021,2,4539,0,282,2,4821,FALSE
South West,28/06/2021,0,4539,0,282,0,4821,FALSE
South West,29/06/2021,1,4540,0,282,1,4822,FALSE
South West,30/06/2021,0,4540,0,282,0,4822,FALSE
South West,01/07/2021,0,4540,0,282,0,4822,FALSE
South West,02/07/2021,1,4541,0,282,1,4823,FALSE
South West,03/07/2021,2,4543,0,282,2,4825,FALSE
South West,04/07/2021,1,4544,0,282,1,4826,FALSE
South West,05/07/2021,0,4544,0,282,0,4826,FALSE
South West,06/07/2021,0,4544,0,282,0,4826,FALSE
South West,07/07/2021,0,4544,2,284,2,4828,FALSE
South West,08/07/2021,0,4544,0,284,0,4828,FALSE
South West,09/07/2021,1,4545,0,284,1,4829,FALSE
South West,10/07/2021,1,4546,0,284,1,4830,FALSE
South West,11/07/2021,1,4547,0,284,1,4831,FALSE
South West,12/07/2021,4,4551,0,284,4,4835,FALSE
South West,13/07/2021,0,4551,0,284,0,4835,FALSE
South West,14/07/2021,1,4552,1,285,2,4837,FALSE
South West,15/07/2021,1,4553,0,285,1,4838,FALSE
South West,16/07/2021,0,4553,0,285,0,4838,FALSE
South West,17/07/2021,5,4558,0,285,5,4843,FALSE
South West,18/07/2021,4,4562,0,285,4,4847,FALSE
South West,19/07/2021,2,4564,0,285,2,4849,FALSE
South West,20/07/2021,0,4564,0,285,0,4849,FALSE
South West,21/07/2021,1,4565,0,285,1,4850,FALSE
South West,22/07/2021,5,4570,0,285,5,4855,FALSE
South West,23/07/2021,8,4578,0,285,8,4863,FALSE
South West,24/07/2021,2,4580,0,285,2,4865,FALSE
South West,25/07/2021,4,4584,0,285,4,4869,FALSE
South West,26/07/2021,1,4585,0,285,1,4870,FALSE
South West,27/07/2021,4,4589,0,285,4,4874,FALSE
South West,28/07/2021,4,4593,0,285,4,4878,FALSE
South West,29/07/2021,1,4594,0,285,1,4879,FALSE
South West,30/07/2021,3,4597,0,285,3,4882,FALSE
South West,31/07/2021,3,4600,0,285,3,4885,FALSE
South West,01/08/2021,6,4606,0,285,6,4891,FALSE
South West,02/08/2021,5,4611,0,285,5,4896,FALSE
South West,03/08/2021,4,4615,2,287,6,4902,FALSE
South West,04/08/2021,4,4619,0,287,4,4906,FALSE
South West,05/08/2021,2,4621,0,287,2,4908,FALSE
South West,06/08/2021,5,4626,0,287,5,4913,FALSE
South West,07/08/2021,4,4630,0,287,4,4917,FALSE
South West,08/08/2021,7,4637,0,287,7,4924,FALSE
South West,09/08/2021,5,4642,0,287,5,4929,FALSE
South West,10/08/2021,4,4646,1,288,5,4934,FALSE
South West,11/08/2021,2,4648,0,288,2,4936,FALSE
South West,12/08/2021,6,4654,0,288,6,4942,FALSE
South West,13/08/2021,2,4656,0,288,2,4944,FALSE
South West,14/08/2021,6,4662,0,288,6,4950,FALSE
South West,15/08/2021,2,4664,0,288,2,4952,FALSE
South West,16/08/2021,3,4667,0,288,3,4955,FALSE
South West,17/08/2021,5,4672,0,288,5,4960,FALSE
South West,18/08/2021,6,4678,0,288,6,4966,FALSE
South West,19/08/2021,7,4685,0,288,7,4973,FALSE
South West,20/08/2021,7,4692,0,288,7,4980,FALSE
South West,21/08/2021,6,4698,0,288,6,4986,FALSE
South West,22/08/2021,10,4708,0,288,10,4996,FALSE
South West,23/08/2021,7,4715,1,289,8,5004,FALSE
South West,24/08/2021,8,4723,0,289,8,5012,FALSE
South West,25/08/2021,6,4729,0,289,6,5018,FALSE
South West,26/08/2021,10,4739,0,289,10,5028,FALSE
South West,27/08/2021,6,4745,1,290,7,5035,FALSE
South West,28/08/2021,8,4753,0,290,8,5043,FALSE
South West,29/08/2021,11,4764,0,290,11,5054,FALSE
South West,30/08/2021,7,4771,1,291,8,5062,FALSE
South West,31/08/2021,5,4776,0,291,5,5067,FALSE
South West,01/09/2021,7,4783,0,291,7,5074,FALSE
South West,02/09/2021,8,4791,0,291,8,5082,FALSE
South West,03/09/2021,6,4797,0,291,6,5088,FALSE
South West,04/09/2021,4,4801,0,291,4,5092,FALSE
South West,05/09/2021,7,4808,0,291,7,5099,FALSE
South West,06/09/2021,11,4819,1,292,12,5111,FALSE
South West,07/09/2021,10,4829,0,292,10,5121,FALSE
South West,08/09/2021,8,4837,0,292,8,5129,FALSE
South West,09/09/2021,9,4846,0,292,9,5138,FALSE
South West,10/09/2021,6,4852,0,292,6,5144,FALSE
South West,11/09/2021,8,4860,1,293,9,5153,FALSE
South West,12/09/2021,5,4865,0,293,5,5158,FALSE
South West,13/09/2021,7,4872,0,293,7,5165,FALSE
South West,14/09/2021,8,4880,1,294,9,5174,FALSE
South West,15/09/2021,6,4886,0,294,6,5180,FALSE
South West,16/09/2021,5,4891,1,295,6,5186,FALSE
South West,17/09/2021,9,4900,0,295,9,5195,FALSE
South West,18/09/2021,9,4909,0,295,9,5204,FALSE
South West,19/09/2021,3,4912,0,295,3,5207,FALSE
South West,20/09/2021,5,4917,1,296,6,5213,FALSE
South West,21/09/2021,2,4919,0,296,2,5215,FALSE
South West,22/09/2021,7,4926,1,297,8,5223,FALSE
South West,23/09/2021,7,4933,1,298,8,5231,FALSE
South West,24/09/2021,7,4940,2,300,9,5240,FALSE
South West,25/09/2021,9,4949,1,301,10,5250,FALSE
South West,26/09/2021,7,4956,0,301,7,5257,FALSE
South West,27/09/2021,8,4964,0,301,8,5265,FALSE
South West,28/09/2021,6,4970,0,301,6,5271,FALSE
South West,29/09/2021,2,4972,0,301,2,5273,FALSE
South West,30/09/2021,9,4981,0,301,9,5282,FALSE
South West,01/10/2021,6,4987,2,303,8,5290,FALSE
South West,02/10/2021,6,4993,0,303,6,5296,FALSE
South West,03/10/2021,5,4998,1,304,6,5302,FALSE
South West,04/10/2021,7,5005,0,304,7,5309,FALSE
South West,05/10/2021,4,5009,0,304,4,5313,FALSE
South West,06/10/2021,4,5013,0,304,4,5317,FALSE
South West,07/10/2021,4,5017,0,304,4,5321,FALSE
South West,08/10/2021,2,5019,1,305,3,5324,FALSE
South West,09/10/2021,7,5026,0,305,7,5331,FALSE
South West,10/10/2021,4,5030,0,305,4,5335,FALSE
South West,11/10/2021,5,5035,0,305,5,5340,FALSE
South West,12/10/2021,5,5040,0,305,5,5345,FALSE
South West,13/10/2021,5,5045,1,306,6,5351,FALSE
South West,14/10/2021,8,5053,0,306,8,5359,FALSE
South West,15/10/2021,6,5059,3,309,9,5368,FALSE
South West,16/10/2021,7,5066,0,309,7,5375,FALSE
South West,17/10/2021,7,5073,0,309,7,5382,FALSE
South West,18/10/2021,6,5079,0,309,6,5388,FALSE
South West,19/10/2021,3,5082,0,309,3,5391,FALSE
South West,20/10/2021,4,5086,0,309,4,5395,FALSE
South West,21/10/2021,10,5096,0,309,10,5405,FALSE
South West,22/10/2021,9,5105,0,309,9,5414,FALSE
South West,23/10/2021,14,5119,0,309,14,5428,FALSE
South West,24/10/2021,3,5122,0,309,3,5431,FALSE
South West,25/10/2021,8,5130,0,309,8,5439,FALSE
South West,26/10/2021,19,5149,0,309,19,5458,FALSE
South West,27/10/2021,10,5159,0,309,10,5468,FALSE
South West,28/10/2021,8,5167,0,309,8,5476,FALSE
South West,29/10/2021,11,5178,0,309,11,5487,FALSE
South West,30/10/2021,7,5185,0,309,7,5494,FALSE
South West,31/10/2021,8,5193,1,310,9,5503,FALSE
South West,01/11/2021,12,5205,1,311,13,5516,FALSE
South West,02/11/2021,11,5216,0,311,11,5527,FALSE
South West,03/11/2021,9,5225,1,312,10,5537,FALSE
South West,04/11/2021,9,5234,2,314,11,5548,FALSE
South West,05/11/2021,12,5246,0,314,12,5560,FALSE
South West,06/11/2021,10,5256,0,314,10,5570,FALSE
South West,07/11/2021,8,5264,0,314,8,5578,FALSE
South West,08/11/2021,9,5273,0,314,9,5587,FALSE
South West,09/11/2021,14,5287,0,314,14,5601,FALSE
South West,10/11/2021,9,5296,1,315,10,5611,FALSE
South West,11/11/2021,7,5303,1,316,8,5619,FALSE
South West,12/11/2021,5,5308,1,317,6,5625,FALSE
South West,13/11/2021,5,5313,0,317,5,5630,FALSE
South West,14/11/2021,10,5323,0,317,10,5640,FALSE
South West,15/11/2021,12,5335,1,318,13,5653,FALSE
South West,16/11/2021,8,5343,0,318,8,5661,FALSE
South West,17/11/2021,8,5351,0,318,8,5669,FALSE
South West,18/11/2021,7,5358,0,318,7,5676,FALSE
South West,19/11/2021,7,5365,0,318,7,5683,FALSE
South West,20/11/2021,7,5372,2,320,9,5692,FALSE
South West,21/11/2021,6,5378,1,321,7,5699,FALSE
South West,22/11/2021,9,5387,0,321,9,5708,FALSE
South West,23/11/2021,7,5394,0,321,7,5715,FALSE
South West,24/11/2021,6,5400,1,322,7,5722,FALSE
South West,25/11/2021,9,5409,1,323,10,5732,FALSE
South West,26/11/2021,6,5415,0,323,6,5738,FALSE
South West,27/11/2021,11,5426,0,323,11,5749,FALSE
South West,28/11/2021,7,5433,0,323,7,5756,FALSE
South West,29/11/2021,8,5441,1,324,9,5765,FALSE
South West,30/11/2021,5,5446,1,325,6,5771,FALSE
South West,01/12/2021,9,5455,1,326,10,5781,FALSE
South West,02/12/2021,3,5458,0,326,3,5784,FALSE
South West,03/12/2021,6,5464,0,326,6,5790,FALSE
South West,04/12/2021,7,5471,0,326,7,5797,FALSE
South West,05/12/2021,9,5480,1,327,10,5807,FALSE
South West,06/12/2021,5,5485,1,328,6,5813,FALSE
South West,07/12/2021,2,5487,0,328,2,5815,FALSE
South West,08/12/2021,10,5497,2,330,12,5827,FALSE
South West,09/12/2021,9,5506,0,330,9,5836,FALSE
South West,10/12/2021,6,5512,0,330,6,5842,FALSE
South West,11/12/2021,7,5519,0,330,7,5849,FALSE
South West,12/12/2021,7,5526,1,331,8,5857,FALSE
South West,13/12/2021,9,5535,0,331,9,5866,FALSE
South West,14/12/2021,10,5545,0,331,10,5876,FALSE
South West,15/12/2021,9,5554,1,332,10,5886,FALSE
South West,16/12/2021,10,5564,1,333,11,5897,FALSE
South West,17/12/2021,13,5577,1,334,14,5911,FALSE
South West,18/12/2021,8,5585,0,334,8,5919,FALSE
South West,19/12/2021,10,5595,0,334,10,5929,FALSE
South West,20/12/2021,4,5599,0,334,4,5933,FALSE
South West,21/12/2021,5,5604,0,334,5,5938,FALSE
South West,22/12/2021,8,5612,1,335,9,5947,FALSE
South West,23/12/2021,5,5617,1,336,6,5953,FALSE
South West,24/12/2021,2,5619,1,337,3,5956,FALSE
South West,25/12/2021,2,5621,0,337,2,5958,FALSE
South West,26/12/2021,9,5630,0,337,9,5967,FALSE
South West,27/12/2021,4,5634,0,337,4,5971,FALSE
South West,28/12/2021,13,5647,0,337,13,5984,FALSE
South West,29/12/2021,6,5653,0,337,6,5990,FALSE
South West,30/12/2021,11,5664,2,339,13,6003,FALSE
South West,31/12/2021,5,5669,0,339,5,6008,FALSE
South West,01/01/2022,9,5678,0,339,9,6017,FALSE
South West,02/01/2022,6,5684,0,339,6,6023,FALSE
South West,03/01/2022,10,5694,2,341,12,6035,FALSE
South West,04/01/2022,8,5702,0,341,8,6043,FALSE
South West,05/01/2022,10,5712,0,341,10,6053,FALSE
South West,06/01/2022,10,5722,1,342,11,6064,FALSE
South West,07/01/2022,7,5729,3,345,10,6074,FALSE
South West,08/01/2022,10,5739,1,346,11,6085,FALSE
South West,09/01/2022,8,5747,1,347,9,6094,FALSE
South West,10/01/2022,6,5753,1,348,7,6101,FALSE
South West,11/01/2022,6,5759,0,348,6,6107,FALSE
South West,12/01/2022,14,5773,0,348,14,6121,FALSE
South West,13/01/2022,8,5781,0,348,8,6129,FALSE
South West,14/01/2022,7,5788,3,351,10,6139,FALSE
South West,15/01/2022,7,5795,0,351,7,6146,FALSE
South West,16/01/2022,9,5804,1,352,10,6156,FALSE
South West,17/01/2022,8,5812,1,353,9,6165,FALSE
South West,18/01/2022,7,5819,0,353,7,6172,FALSE
South West,19/01/2022,9,5828,0,353,9,6181,FALSE
South West,20/01/2022,7,5835,0,353,7,6188,FALSE
South West,21/01/2022,7,5842,0,353,7,6195,FALSE
South West,22/01/2022,6,5848,0,353,6,6201,FALSE
South West,23/01/2022,5,5853,0,353,5,6206,FALSE
South West,24/01/2022,11,5864,0,353,11,6217,FALSE
South West,25/01/2022,13,5877,1,354,14,6231,FALSE
South West,26/01/2022,6,5883,1,355,7,6238,FALSE
South West,27/01/2022,5,5888,0,355,5,6243,FALSE
South West,28/01/2022,5,5893,0,355,5,6248,FALSE
South West,29/01/2022,5,5898,0,355,5,6253,FALSE
South West,30/01/2022,8,5906,0,355,8,6261,FALSE
South West,31/01/2022,6,5912,0,355,6,6267,FALSE
South West,01/02/2022,2,5914,0,355,2,6269,FALSE
South West,02/02/2022,15,5929,0,355,15,6284,TRUE
South West,03/02/2022,7,5936,0,355,7,6291,TRUE
South West,04/02/2022,3,5939,0,355,3,6294,TRUE
South West,05/02/2022,0,5939,0,355,0,6294,TRUE
South West,06/02/2022,0,5939,0,355,0,6294,TRUE
